Acanthaceae	Asteridae
Amaryllidaceae	Liliidae
Anacardiaceae	Rosidae
Annonaceae	Magnoliidae
Apiaceae	Asteridae
Apocynaceae	Asteridae
Aquifoliaceae	Asteridae
Araceae	Liliidae
Araliaceae	Asteridae
Arecaceae	Liliidae
Asparagaceae	Liliidae
Aspleniaceae	Pteridophyta
Asteraceae	Asteridae
Balsaminaceae	Asteridae
Begoniaceae	Rosidae
Bignoniaceae	Asteridae
Blechnaceae	Pteridophyta
Boraginaceae	Asteridae
Bromeliaceae	Liliidae
Burmanniaceae	Liliidae
Burseraceae	Rosidae
Cactaceae	Asteridae
Calophyllaceae	Rosidae
Campanulaceae	Asteridae
Canellaceae	Magnoliidae
Cannabaceae	Rosidae
Casuarinaceae	Rosidae
Celastraceae	Rosidae
Chloranthaceae	Magnoliidae
Chrysobalanaceae	Rosidae
Clusiaceae	Rosidae
Combretaceae	Rosidae
Commelinaceae	Liliidae
Connaraceae	Rosidae
Convolvulaceae	Asteridae
Costaceae	Liliidae
Crassulaceae	Rosidae
Cucurbitaceae	Rosidae
Cyatheaceae	Pteridophyta
Cyperaceae	Liliidae
Cyrillaceae	Asteridae
Davalliaceae	Pteridophyta
Dennstaedtiaceae	Pteridophyta
Dilleniaceae	Rosidae
Dioscoreaceae	Liliidae
Dryopteridaceae	Pteridophyta
Elaeocarpaceae	Rosidae
Euphorbiaceae	Rosidae
Fabaceae	Rosidae
Gentianaceae	Asteridae
Gesneriaceae	Asteridae
Gleicheniaceae	Pteridophyta
Haemodoraceae	Liliidae
Heliconiaceae	Liliidae
Hemidictyaceae	Pteridophyta
Hymenophyllaceae	Pteridophyta
Hypoxidaceae	Liliidae
Iridaceae	Liliidae
Lamiaceae	Asteridae
Lauraceae	Magnoliidae
Linderniaceae	Asteridae
Lindsaeaceae	Pteridophyta
Lomariopsidaceae	Pteridophyta
Lycopodiaceae	Pteridophyta
Lythraceae	Rosidae
Magnoliaceae	Magnoliidae
Malpighiaceae	Rosidae
Malvaceae	Rosidae
Marantaceae	Liliidae
Marattiaceae	Pteridophyta
Marcgraviaceae	Asteridae
Melastomataceae	Rosidae
Meliaceae	Rosidae
Menispermaceae	Magnoliidae
Moraceae	Rosidae
Musaceae	Liliidae
Myrtaceae	Rosidae
Nyctaginaceae	Asteridae
Ochnaceae	Rosidae
Oleaceae	Asteridae
Oleandraceae	Pteridophyta
Onagraceae	Rosidae
Orchidaceae	Liliidae
Oxalidaceae	Rosidae
Passifloraceae	Rosidae
Pentaphylacaceae	Asteridae
Phyllanthaceae	Rosidae
Phytolaccaceae	Asteridae
Piperaceae	Magnoliidae
Plantaginaceae	Asteridae
Poaceae	Liliidae
Polygalaceae	Rosidae
Polygonaceae	Asteridae
Polypodiaceae	Pteridophyta
Primulaceae	Asteridae
Psilotaceae	Pteridophyta
Pteridaceae	Pteridophyta
Putranjivaceae	Rosidae
Rhamnaceae	Rosidae
Rhizophoraceae	Rosidae
Rubiaceae	Asteridae
Rutaceae	Rosidae
Sabiaceae	Magnoliidae
Salicaceae	Rosidae
Santalaceae	Asteridae
Sapindaceae	Rosidae
Sapotaceae	Asteridae
Schlegeliaceae	Asteridae
Selaginellaceae	Pteridophyta
Simaroubaceae	Rosidae
Smilacaceae	Liliidae
Solanaceae	Rosidae
Staphyleaceae	Rosidae
Symplocaceae	Asteridae
Tectariaceae	Pteridophyta
Theaceae	Asteridae
Thelypteridaceae	Pteridophyta
Thymelaeaceae	Rosidae
Urticaceae	Rosidae
Verbenaceae	Asteridae
Vitaceae	Rosidae
Zingiberaceae	Liliidae
Ericaceae	Asteridae
Rosaceae	Rosidae
Myricaceae	Rosidae
Styracaceae	Asteridae
Zygophyllaceae	Rosidae
Hydrophyllaceae	Asteridae
