Abrodictyum	Hymenophyllaceae
Acmella	Asteraceae
Adiantum	Pteridaceae
Aechmea	Bromeliaceae
Aeschynomene	Fabaceae
Alchornea	Euphorbiaceae
Alchorneopsis	Euphorbiaceae
Allamanda	Apocynaceae
Alpinia	Zingiberaceae
Alsophila	Cyatheaceae
Andira	Fabaceae
Andropogon	Poaceae
Anetium	Pteridaceae
Anthurium	Araceae
Apteria	Burmanniaceae
Ardisia	Primulaceae
Arthrostylidium	Poaceae
Artocarpus	Moraceae
Arundina	Orchidaceae
Arundinella	Poaceae
Asclepias	Apocynaceae
Asplenium	Aspleniaceae
Axonopus	Poaceae
Bacopa	Plantaginaceae
Bambusa	Poaceae
Barbieria	Fabaceae
Begonia	Begoniaceae
Beilschmiedia	Lauraceae
Bidens	Asteraceae
Blechnum	Blechnaceae
Brunfelsia	Solanaceae
Buchenavia	Combretaceae
Byrsonima	Malpighiaceae
Caladium	Araceae
Calathea	Marantaceae
Calophyllum	Calophyllaceae
Calyptranthes	Myrtaceae
Campylocentrum	Orchidaceae
Campyloneurum	Polypodiaceae
Cananga	Annonaceae
Caperonia	Euphorbiaceae
Casearia	Salicaceae
Cassipourea	Rhizophoraceae
Casuarina	Casuarinaceae
Catopsis	Bromeliaceae
Cayaponia	Cucurbitaceae
Cecropia	Urticaceae
Ceiba	Malvaceae
Cenchrus	Poaceae
Centrosema	Fabaceae
Cestrum	Solanaceae
Chamaecrista	Fabaceae
Cheilocostus	Costaceae
Chiococca	Rubiaceae
Chionanthus	Oleaceae
Chione	Rubiaceae
Chloris	Poaceae
Chrysophyllum	Sapotaceae
Chrysothemis	Gesneriaceae
Cinnamomum	Lauraceae
Cissampelos	Menispermaceae
Cissus	Vitaceae
Citharexylum	Verbenaceae
Citrus	Rutaceae
Clerodendrum	Lamiaceae
Clibadium	Asteraceae
Clidemia	Melastomataceae
Clusia	Clusiaceae
Coccoloba	Polygonaceae
Cochleanthes	Orchidaceae
Cochlidium	Polypodiaceae
Cocos	Arecaceae
Codiaeum	Euphorbiaceae
Coffea	Rubiaceae
Colocasia	Araceae
Columnea	Gesneriaceae
Commelina	Commelinaceae
Comocladia	Anacardiaceae
Cordia	Hydrophyllaceae
Cordyline	Asparagaceae
Cranichis	Orchidaceae
Critonia	Asteraceae
Crotalaria	Fabaceae
Croton	Euphorbiaceae
Cupania	Sapindaceae
Cuphea	Lythraceae
Curcuma	Zingiberaceae
Cyanthillium	Asteraceae
Cyathea	Cyatheaceae
Cyclopogon	Orchidaceae
Cyclospermum	Apiaceae
Cyperus	Cyperaceae
Cyrilla	Cyrillaceae
Dacryodes	Burseraceae
Dalbergia	Fabaceae
Danaea	Marattiaceae
Daphnopsis	Thymelaeaceae
Delonix	Fabaceae
Dendropanax	Araliaceae
Dennstaedtia	Dennstaedtiaceae
Desmanthus	Fabaceae
Desmodium	Fabaceae
Dichaea	Orchidaceae
Dichanthelium	Poaceae
Didymoglossum	Hymenophyllaceae
Dieffenbachia	Araceae
Digitaria	Poaceae
Diodia	Rubiaceae
Dioscorea	Dioscoreaceae
Ditta	Euphorbiaceae
Dolichandra	Bignoniaceae
Dracaena	Asparagaceae
Drypetes	Putranjivaceae
Eclipta	Asteraceae
Elaphoglossum	Dryopteridaceae
Eleocharis	Cyperaceae
Elephantopus	Asteraceae
Eleusine	Poaceae
Elleanthus	Orchidaceae
Emilia	Asteraceae
Epidendrum	Orchidaceae
Epipremnum	Araceae
Episcia	Gesneriaceae
Erechtites	Asteraceae
Erigeron	Asteraceae
Eriochloa	Poaceae
Eryngium	Apiaceae
Etlingera	Zingiberaceae
Eucalyptus	Myrtaceae
Eugenia	Myrtaceae
Euphorbia	Euphorbiaceae
Faramea	Rubiaceae
Ficus	Moraceae
Fimbristylis	Cyperaceae
Fleischmannia	Asteraceae
Fuirena	Cyperaceae
Garcinia	Clusiaceae
Genipa	Rubiaceae
Gleichenella	Gleicheniaceae
Gonzalagunia	Rubiaceae
Graptophyllum	Acanthaceae
Guarea	Meliaceae
Guatteria	Annonaceae
Guazuma	Malvaceae
Guettarda	Rubiaceae
Guzmania	Bromeliaceae
Gymnosiphon	Burmanniaceae
Haenianthus	Oleaceae
Hamelia	Rubiaceae
Hedychium	Zingiberaceae
Hedyosmum	Chloranthaceae
Heliconia	Heliconiaceae
Hemidictyum	Hemidictyaceae
Henriettea	Melastomataceae
Heteropterys	Malpighiaceae
Heterotis	Melastomataceae
Hibiscus	Malvaceae
Hillia	Rubiaceae
Hippocratea	Celastraceae
Hirtella	Chrysobalanaceae
Hohenbergia	Bromeliaceae
Homalium	Salicaceae
Homolepis	Poaceae
Huperzia	Lycopodiaceae
Hymenocallis	Amaryllidaceae
Hymenophyllum	Hymenophyllaceae
Hypolepis	Dennstaedtiaceae
Hypoxis	Hypoxidaceae
Hyptis	Lamiaceae
Ichnanthus	Poaceae
Ilex	Aquifoliaceae
Impatiens	Balsaminaceae
Inga	Fabaceae
Ipomoea	Convolvulaceae
Ixora	Rubiaceae
Jacquiniella	Orchidaceae
Justicia	Acanthaceae
Kalanchoe	Crassulaceae
Kyllinga	Cyperaceae
Laetia	Salicaceae
Lantana	Verbenaceae
Laplacea	Theaceae
Lasiacis	Poaceae
Lasianthus	Rubiaceae
Leochilus	Orchidaceae
Lepanthes	Orchidaceae
Lepidagathis	Acanthaceae
Leucaena	Fabaceae
Lindernia	Linderniaceae
Lindsaea	Lindsaeaceae
Liparis	Orchidaceae
Lisianthius	Gentianaceae
Lobelia	Campanulaceae
Lomariopsis	Lomariopsidaceae
Lonchocarpus	Fabaceae
Ludwigia	Onagraceae
Lunania	Salicaceae
Lycopodiella	Lycopodiaceae
Macroptilium	Fabaceae
Macrothelypteris	Thelypteridaceae
Maesopsis	Rhamnaceae
Magnolia	Magnoliaceae
Malaxis	Orchidaceae
Malpighia	Malpighiaceae
Malvaviscus	Malvaceae
Mammea	Calophyllaceae
Mangifera	Anacardiaceae
Manilkara	Sapotaceae
Marcgravia	Marcgraviaceae
Margaritaria	Phyllanthaceae
Matayba	Sapindaceae
Matelea	Apocynaceae
Maytenus	Celastraceae
Mecardonia	Plantaginaceae
Mecranium	Melastomataceae
Megalastrum	Dryopteridaceae
Megathyrsus	Poaceae
Melanthera	Asteraceae
Melinis	Poaceae
Meliosma	Sabiaceae
Mickelia	Dryopteridaceae
Miconia	Melastomataceae
Microchilus	Orchidaceae
Microgramma	Polypodiaceae
Micropholis	Sapotaceae
Mikania	Asteraceae
Mimosa	Fabaceae
Molineria	Hypoxidaceae
Moranopteris	Polypodiaceae
Mormolyca	Orchidaceae
Musa	Musaceae
Myrcia	Myrtaceae
Myrsine	Primulaceae
Nectandra	Lauraceae
Neorudolphia	Fabaceae
Nephrolepis	Davalliaceae
Nepsera	Melastomataceae
Neurolaena	Asteraceae
Niphidium	Polypodiaceae
Notopleura	Rubiaceae
Ochroma	Malvaceae
Ocotea	Lauraceae
Odontonema	Acanthaceae
Odontosoria	Lindsaeaceae
Oeceoclades	Orchidaceae
Oldenlandia	Rubiaceae
Oleandra	Oleandraceae
Olfersia	Dryopteridaceae
Olyra	Poaceae
Oncidium	Orchidaceae
Oplismenus	Poaceae
Ormosia	Fabaceae
Ornithidium	Orchidaceae
Oxalis	Oxalidaceae
Oxandra	Annonaceae
Palicourea	Rubiaceae
Panicum	Poaceae
Parathesis	Primulaceae
Paspalum	Poaceae
Passiflora	Passifloraceae
Paullinia	Sapindaceae
Pavonia	Malvaceae
Pecluma	Polypodiaceae
Pelexia	Orchidaceae
Pentas	Rubiaceae
Peperomia	Piperaceae
Persea	Lauraceae
Petitia	Lamiaceae
Pharus	Poaceae
Philodendron	Araceae
Phlebodium	Polypodiaceae
Phoradendron	Santalaceae
Phyllanthus	Phyllanthaceae
Physalis	Solanaceae
Phytolacca	Phytolaccaceae
Pilea	Urticaceae
Pimenta	Myrtaceae
Pinochia	Apocynaceae
Pinzona	Dilleniaceae
Piper	Piperaceae
Piptocarpha	Asteraceae
Pisonia	Nyctaginaceae
Pitcairnia	Bromeliaceae
Pityrogramma	Pteridaceae
Plectranthus	Lamiaceae
Pleodendron	Canellaceae
Pleopeltis	Polypodiaceae
Pleurothallis	Orchidaceae
Pluchea	Asteraceae
Plumeria	Apocynaceae
Poitea	Fabaceae
Polygala	Polygalaceae
Polypodium	Polypodiaceae
Polyscias	Araliaceae
Polystachya	Orchidaceae
Polystichopsis	Dryopteridaceae
Polytaenium	Pteridaceae
Prescottia	Orchidaceae
Prestoea	Arecaceae
Prosthechea	Orchidaceae
Pseudelephantopus	Asteraceae
Pseudolmedia	Moraceae
Psidium	Myrtaceae
Psilotum	Psilotaceae
Psychotria	Rubiaceae
Pterocarpus	Fabaceae
Pueraria	Fabaceae
Quararibea	Malvaceae
Radiovittaria	Pteridaceae
Rajania	Dioscoreaceae
Ravenia	Rutaceae
Renealmia	Zingiberaceae
Rhipsalis	Cactaceae
Rhynchospora	Cyperaceae
Rolandra	Asteraceae
Rondeletia	Rubiaceae
Rourea	Connaraceae
Roystonea	Arecaceae
Ruellia	Acanthaceae
Rumohra	Dryopteridaceae
Sacciolepis	Poaceae
Samyda	Salicaceae
Sapium	Euphorbiaceae
Sauvagesia	Ochnaceae
Scaphyglottis	Orchidaceae
Schefflera	Araliaceae
Schlegelia	Schlegeliaceae
Schradera	Rubiaceae
Scleria	Cyperaceae
Securidaca	Polygalaceae
Selaginella	Selaginellaceae
Senna	Fabaceae
Serpocaulon	Polypodiaceae
Setaria	Poaceae
Sida	Malvaceae
Simarouba	Simaroubaceae
Sloanea	Elaeocarpaceae
Smilax	Smilacaceae
Solanum	Solanaceae
Spathodea	Bignoniaceae
Spathoglottis	Orchidaceae
Spermacoce	Rubiaceae
Sphagneticola	Asteraceae
Spiranthes	Orchidaceae
Sporobolus	Poaceae
Stachytarpheta	Verbenaceae
Steinchisma	Poaceae
Stelis	Orchidaceae
Stenostomum	Rubiaceae
Sticherus	Gleicheniaceae
Swietenia	Meliaceae
Symplocos	Symplocaceae
Synedrella	Asteraceae
Syngonium	Araceae
Syzygium	Myrtaceae
Tabebuia	Bignoniaceae
Tabernaemontana	Apocynaceae
Talipariti	Malvaceae
Tectaria	Tectariaceae
Tectona	Lamiaceae
Ternstroemia	Pentaphylacaceae
Terpsichore	Polypodiaceae
Tetragastris	Burseraceae
Tetrazygia	Melastomataceae
Thelypteris	Thelypteridaceae
Theobroma	Malvaceae
Tillandsia	Bromeliaceae
Tournefortia	Hydrophyllaceae
Trema	Cannabaceae
Trichilia	Meliaceae
Trichomanes	Hymenophyllaceae
Trichosalpinx	Orchidaceae
Trichostigma	Phytolaccaceae
Trimezia	Iridaceae
Triphora	Orchidaceae
Tripogandra	Commelinaceae
Turpinia	Staphyleaceae
Urena	Malvaceae
Urera	Urticaceae
Vanilla	Orchidaceae
Varronia	Hydrophyllaceae
Vigna	Fabaceae
Vitex	Lamiaceae
Vitis	Vitaceae
Vittaria	Pteridaceae
Voyria	Gentianaceae
Vriesea	Bromeliaceae
Wallenia	Primulaceae
Wullschlaegelia	Orchidaceae
Xanthosoma	Araceae
Xiphidium	Haemodoraceae
Xylosma	Salicaceae
Youngia	Asteraceae
Zanthoxylum	Rutaceae
Zingiber	Zingiberaceae
Gesneria	Gesneriaceae
Gonocalyx	Ericaceae
Rubus	Rosaceae
Annona	Annonaceae
Callicarpa	Lamiaceae
Calyptronoma	Arecaceae
Dypsis	Arecaceae
Guaiacum	Zygophyllaceae
Marlierea	Myrtaceae
Morella	Myricaceae
Styrax	Styracaceae
Tecoma	Bignoniaceae
Terminalia	Combretaceae
Thespesia	Malvaceae
Sanchezia	Acanthaceae
