Abelmoschus esculentus	(L.) Moench
Abelmoschus moschatus	Medik.
Abildgaardia ovata	(Burm. f.) Kral
Abrodictyum rigidum	(Sw.) Ebihara & Dubuisson
Abrus precatorius	L.
Abutilon abutiloides	(Jacq.) Garcke ex Hochr.
Abutilon hirtum	(Lam.) Sweet
Abutilon hulseanum	(Torr. & A. Gray) Torr. ex A. Gray
Abutilon indicum	(L.) Sweet
Abutilon permolle	(Willd.) Sweet
Acalypha alopecuroidea	Jacq.
Acalypha berteriana	Müll. Arg.
Acalypha bisetosa	Bertol. ex Spreng.
Acalypha chamaedryfolia	(Lam.) Müll. Arg.
Acalypha hispida	Burm. f.
Acalypha ostryifolia	Riddell
Acalypha poiretii	Spreng.
Acalypha portoricensis	Müll. Arg.
Acalypha setosa	A. Rich.
Acanthospermum hispidum	DC.
Achyranthes aspera	L.
Acisanthera quadrata	Pers.
Acmella iodiscaea	(A.H. Moore) R.K. Jansen
Acmella iodiscaea	(A.H.Moore) R.K.Jansen
Acmella pusilla	(Hook. & Arn.) R.K. Jansen
Acnistus arborescens	(L.) Schltdl.
Acrocomia media	O.F. Cook
Acrostichum aureum	L.
Acrostichum danaeifolium	Langsd. & Fisch.
Adansonia digitata	L.
Adelia ricinella	L.
Adenanthera pavonina	L.
Adenostemma verbesina	(L.) Sch. Bip.
Adiantum capillus-veneris	L.
Adiantum concinnum	Humb. & Bonpl. ex Willd.
Adiantum fragile	Sw.
Adiantum latifolium	Lam.
Adiantum macrophyllum	Sw.
Adiantum melanoleucum	Willd.
Adiantum obliquum	Willd.
Adiantum petiolatum	Desv.
Adiantum pulverulentum	L.
Adiantum pyramidale	(L.) Willd.
Adiantum tenerum	Sw.
Adiantum tetraphyllum	Humb. & Bonpl. ex Willd.
Adiantum villosum	L.
Adiantum vivesii	Proctor
Adiantum wilsonii	Hook.
Aechmea fasciata	(Lindl.) Baker
Aechmea lingulata	(L.) Baker
Aechmea nudicaulis	(L.) Griseb.
Aegiphila elata	Sw.
Aegiphila martinicensis	Jacq.
Aeschynomene americana	L.
Aeschynomene evenia	C. Wright
Aeschynomene gracilis	Vogel
Aeschynomene indica	L.
Aeschynomene rudis	Benth.
Aeschynomene sensitiva	Sw.
Aeschynomene villosa	Poir.
Agalinis fasciculata	(Elliott) Raf.
Agathis robusta	(C. Moore ex F. Muell.) F.M. Bailey
Agave minor	Proctor
Agave missionum	Trel.
Agave sisalana	Perrine
Agdestis clematidea	Moc. & Sessé ex DC.
Ageratina resiniflua	(Urb.) R.M. King & H. Rob.
Ageratum conyzoides	L.
Aglaonema commutatum	Schott
Aglaonema pictum	(Roxb.) Kunth
Agrostis hyemalis	(Walter) Britton, Sterns & Poggenb.
Aiphanes minima	(Gaertn.) Burret
Albizia adinocephala	(Donn. Sm.) Britton & Rose ex Record
Albizia carbonaria	Britton
Albizia lebbeck	(L.) Benth.
Albizia procera	(Roxb.) Benth.
Alcea rosea	L.
Alchornea latifolia	Sw.
Alchorneopsis floribunda	(Benth.) Müll. Arg.
Alchorneopsis floribunda	(Benth.) Müll.Arg.
Alchorneopsis portoricensis	Urb.
Alectra fluminensis	(Vell.) Stearn
Aleurites moluccanus	(L.) Willd.
Allamanda blanchetii	A. DC.
Allamanda cathartica	L.
Allamanda schottii	Pohl
Allophylus crassinervis	Radlk.
Allophylus racemosus	Sw.
Allosidastrum pyramidatum	(Cav.) Krapov., Fryxell & D.M. Bates
Alocasia macrorrhizos	(L.) G. Don
Alocasia plumbea	K. Koch ex Van Houtte
Aloe vera	(L.) Burm. f.
Aloysia triphylla	(L'Hér.) Britton
Alpinia purpurata	(Vieill.) K. Schum.
Alpinia purpurata	(Vieill.) K.Schum.
Alpinia zerumbet	(Pers.) B.L. Burtt & R.M. Sm.
Alsophila amintae	Conant
Alsophila brooksii	(Maxon) R. Tryon
Alsophila bryophila	R. Tryon
Alsophila portoricensis	(Spreng. ex Kuhn) Conant
Alsophila portoricensis	(Spreng. ex Kuhn) D.S. Conant
Alternanthera bettzichiana	(Regel) Voss
Alternanthera brasiliana	(L.) Kuntze
Alternanthera caracasana	Kunth
Alternanthera crucis	(Moq.) Boldingh
Alternanthera ficoidea	(L.) P. Beauv.
Alternanthera flavescens	Kunth
Alternanthera paronychioides	A. St.-Hil.
Alternanthera philoxeroides	(Mart.) Griseb.
Alternanthera pungens	Kunth
Alternanthera sessilis	(L.) R. Br. ex DC.
Alysicarpus vaginalis	(L.) DC.
Amaranthus australis	(A. Gray) Sauer
Amaranthus blitum	L.
Amaranthus caudatus	L.
Amaranthus crassipes	Schltdl.
Amaranthus cruentus	L.
Amaranthus dubius	Mart. ex Thell.
Amaranthus spinosus	L.
Amaranthus tricolor	L.
Ambrosia confertiflora	DC.
Ambrosia hispida	Pursh
Ambrosia peruviana	Willd.
Ambrosia tenuifolia	Spreng.
Ammannia auriculata	Willd.
Ammannia baccifera	L.
Ammannia coccinea	Rottb.
Ammannia latifolia	L.
Amphilophium paniculatum	(L.) Kunth
Amphitecna latifolia	(Mill.) A.H. Gentry
Amyris balsamifera	L.
Amyris elemifera	L.
Anacardium occidentale	L.
Anadenanthera peregrina	(L.) Speg.
Anagallis arvensis	L.
Ananas comosus	(L.) Merr.
Andira inermis	(Wright)DC.
Andira inermis	(W. Wright) Kunth ex DC.
Andropogon bicornis	L.
Andropogon glomeratus	(Walter) Britton, Sterns & Poggenb.
Andropogon gracilis	Spreng.
Andropogon leucostachyus	Kunth
Andropogon virginicus	L.
Anechites nerium	(Aubl.) Urb.
Anemia adiantifolia	(L.) Sw.
Anemia hirsuta	(L.) Sw.
Anemia hirta	(L.) Sw.
Anemia portoricensis	Maxon
Anethum graveolens	L.
Anetium citrifolium	(L.) Splitg.
Angelonia salicariifolia	Humb. & Bonpl.
Aniba bracteata	(Nees) Mez
Aniseia martinicensis	(Jacq.) Choisy
Annona cherimola	Mill.
Annona glabra	L.
Annona montana	Macfad.
Annona muricata	L.
Annona reticulata	L.
Annona squamosa	L.
Anoda cristata	(L.) Schltdl.
Anopteris hexagona	(L.) C. Chr.
Anredera cordifolia	(Ten.) Steenis
Anredera vesicaria	(Lam.) C.F. Gaertn.
Anthephora hermaphrodita	(L.) Kuntze
Anthurium andraeanum	Linden ex André
Anthurium cordatum	(L.) Schott
Anthurium crenatum	(L.) Kunth
Anthurium dominicense	Schott
Anthurium scandens	(Aubl.) Engl.
Antidaphne wrightii	(Griseb.) Kuijt
Antigonon guatemalense	Meisn.
Antigonon leptopus	Hook. & Arn.
Antirhea acutata	(DC.) Urb.
Antirhea coriacea	(Vahl) Urb.
Antirhea lucida	(Sw.) Hook. f.
Antirhea obtusifolia	Urb.
Antirhea portoricensis	(Britton & P. Wilson) Standl.
Antirhea sintenisii	Urb.
Antrophyum cajenense	(Desv.) Spreng.
Antrophyum intramarginale	(Baker ex Jenman) Kartesz & Gandhi
Antrophyum lanceolatum	(L.) Kaulf.
Antrophyum lineatum	(Sw.) Kaulf.
Antrophyum urbanii	Brause
Apteria aphylla	(Nutt.) Barnhart ex Small
Arachis hypogaea	L.
Arachis repens	Handro
Arachniodes chaerophylloides	(Poir.) Proctor
Ardisia glauciflora	Urb.
Ardisia luquillensis	(Britton) Alain
Ardisia obovata	Desv. ex Ham.
Ardisia solanacea	Roxb.
Argemone mexicana	L.
Argusia gnaphalodes	(L.) Heine
Argyreia nervosa	(Burm. f.) Bojer
Argythamnia candicans	Sw.
Argythamnia fasciculata	(Vahl ex A. Juss.) Müll. Arg.
Argythamnia stahlii	Urb.
Aristida adscensionis	L.
Aristida chaseae	Hitchc.
Aristida portoricensis	Pilg.
Aristida refracta	Griseb.
Aristida spiciformis	Elliott
Aristida suringarii	Henr.
Aristida swartziana	Steud.
Aristolochia bilabiata	L.
Aristolochia elegans	Mast.
Aristolochia ringens	Vahl
Aristolochia trilobata	L.
Arrabidaea chica	(Humb. & Bonpl.) Verl.
Arracacia xanthorrhiza	E.N. Bancroft
Arthraxon castratus	(Griffiths) Naray. ex Bor
Arthrostemma fragile	Lindl.
Arthrostylidium farctum	(Aubl.) Soderstr. & Lourteig.
Arthrostylidium multispicatum	Pilg.
Arthrostylidium sarmentosum	Pilg.
Artocarpus altilis	(Parkinson ex F.A.Zorn) Fosberg
Artocarpus altilis	(Parkinson) Fosberg
Artocarpus heterophyllus	Lam.
Arundina graminifolia	(D. Don) Hochr.
Arundina graminifolia	(D.Don) Hochr.
Arundinella hispida	(Humb. & Bonpl. ex Willd.) Kuntze
Arundinella hispida	(Willd.) Kuntze
Arundo donax	L.
Asclepias curassavica	L.
Asclepias nivea	L.
Asparagus aethiopicus	L.
Asparagus setaceus	(Kunth) Jessop
Asplenium abscissum	Willd.
Asplenium auriculatum	Sw.
Asplenium cirrhatum	Rich. ex Willd.
Asplenium corderoanum	Proctor
Asplenium cristatum	Lam.
Asplenium cuneatum	Lam.
Asplenium erosum	L.
Asplenium feei	Kunze ex Fée
Asplenium flabellulatum	Kunze
Asplenium formosum	Willd.
Asplenium heterochroum	Kunze
Asplenium juglandifolium	Lam.
Asplenium laetum	Sw.
Asplenium obtusifolium	L.
Asplenium ocoense	C. Chr.
Asplenium pseudoerectum	Hieron.
Asplenium pteropus	Kaulf.
Asplenium pumilum	Sw.
Asplenium radicans	L.
Asplenium rhomboidale	Desv.
Asplenium rutaceum	(Willd.) Mett.
Asplenium salicifolium	L.
Asplenium serra	Langsd. & Fisch.
Asplenium serratum	L.
Asplenium sessilifolium	Desv.
Asplenium trichomanes-dentatum	L.
Asplenium uniseriale	Raddi
Asplenium verecundum	Chapm. ex Underw.
Astrolepis sinuata	(Lag. ex Sw.) Benham & Windham
Asystasia gangetica	(L.) T. Anderson
Atriplex cristata	Humb. & Bonpl. ex Willd.
Atriplex littoralis	L.
Auerodendron pauciflorum	Alain
Avena sativa	L.
Averrhoa carambola	L.
Avicennia germinans	(L.) L.
Axonopus aureus	P. Beauv.
Axonopus compressus	(Sw.) P. Beauv.
Axonopus compressus	(Sw.) P.Beauv.
Axonopus fissifolius	(Raddi) Kuhlm.
Ayenia ardua	Cristobal
Ayenia insulicola	Cristobal
Azadirachta indica	A. Juss.
Azolla caroliniana	Willd.
Baccharis dioica	Vahl
Baccharis myrsinites	(Lam.) Pers.
Bacopa innominata	(G. Maza) Alain
Bacopa monnieri	(L.) Pennell
Bacopa monnieri	(L.) Wettst.
Bacopa repens	(Sw.) Wettst.
Bacopa stricta	(Schrad.) B.L. Rob.
Bacopa stricta	(Schrad.) Wettst. ex Edwall
Bambusa multiplex	(Lour.) Raeusch. ex Schult. & Schult. f.
Bambusa vulgaris	Schrad.
Bambusa vulgaris	Schrad. ex J.C. Wendl.
Banara portoricensis	Krug & Urb.
Banara vanderbiltii	Urb.
Banisteriopsis lucida	(Rich.) Small
Barbieria pinnata	(Pers.) Baill.
Barbieria pinnata	(Pers.)Baill.
Barleria cristata	L.
Barleria lupulina	Lindl.
Barleria prionitis	L.
Barleriola solanifolia	(L.) Oerst. ex Lindau
Barringtonia asiatica	(L.) Kurz
Basella alba	L.
Basiphyllaea corallicola	(Small) Ames
Bastardia bivalvis	(Cav.) Kunth
Bastardia viscosa	(L.) Kunth
Bastardiopsis eggersii	(Baker f.) Fuertes & Fryxell
Batis maritima	L.
Bauhinia galpinii	N.E. Br.
Bauhinia monandra	Kurz
Bauhinia multinervia	(Kunth) DC.
Bauhinia pauletia	Pers.
Bauhinia purpurea	L.
Bauhinia tomentosa	L.
Bauhinia variegata	L.
Begonia coccinea	Hook.
Begonia convolvulacea	A. DC.
Begonia cucullata	Willd.
Begonia decandra	Pav. ex A. DC.
Begonia decandra	Pav. ex A.DC.
Begonia heracleifolia	Cham. & Schltdl.
Begonia hirtella	Link
Begonia nelumbiifolia	Cham. & Schltdl.
Beilschmiedia pendula	(Sw.) Hemsl.
Belamcanda chinensis	(L.) DC.
Bernardia dichotoma	(Willd.) Müll. Arg.
Beta vulgaris	L.
Bidens alba	(L.) DC.
Bidens cynapiifolia	Kunth
Bidens pilosa	L.
Bidens reptans	(L.) G. Don
Billbergia pyramidalis	(Sims) Lindl.
Bixa orellana	L.
Blechnum divergens	(Kunze) Mett.
Blechnum fragile	(Liebm.) Morton & Lellinger
Blechnum insularum	Morton & Lellinger
Blechnum lineatum	(Sw.) C. Chr.
Blechnum occidentale	L.
Blechnum polypodioides	Raddi
Blechnum serrulatum	Rich.
Bletia patula	Graham
Blighia sapida	K.D. Koenig
Blutaparon vermiculare	(L.) Mears
Bocconia frutescens	L.
Boehmeria cylindrica	(L.) Sw.
Boehmeria nivea	(L.) Gaudich.
Boehmeria repens	(Griseb.) Weddell
Boerhavia coccinea	Mill.
Boerhavia diffusa	L.
Boerhavia erecta	L.
Boerhavia scandens	L.
Bolbitis aliena	(Sw.) Alston
Bolbitis nicotianifolia	(Sw.) Alston
Bolbitis pergamentacea	(Maxon) Ching
Bolbitis portoricensis	(Spreng.) Hennipman
Bontia daphnoides	L.
Borrichia arborescens	(L.) DC.
Bothriochloa ischaemum	(L.) Keng
Bothriochloa pertusa	(L.) A. Camus
Bothriochloa saccharoides	(Sw.) Rydb.
Botrychium jenmanii	Underw.
Bouchea prismatica	(L.) Kuntze
Bougainvillea glabra	Choisy
Bougainvillea spectabilis	Willd.
Bourreria radula	(Poir.) G. Don
Bourreria succulenta	Jacq.
Bourreria virgata	(Sw.) G. Don
Bouteloua americana	(L.) Scribn.
Bouteloua juncea	(Desv. ex P. Beauv.) Hitchc.
Bouteloua repens	(Kunth) Scribn. & Merr.
Brachionidium ciliolatum	Garay
Brachionidium sherringii	Rolfe
Brachyelytrum erectum	(Schreb. ex Spreng.) P. Beauv.
Bracteantha bracteata	(Vent.) Anderb. & Heagi
Brasiliopuntia brasiliensis	(Willd.) A. Berger
Brassavola cucullata	(L.) R. Br.
Brassavola nodosa	(L.) Lindl.
Brassica juncea	(L.) Czern.
Brassica oleracea	L.
Breynia disticha	J.R. Forst. & G. Forst.
Bromelia pinguin	L.
Broughtonia domingensis	(Lindl.) Rolfe
Browallia americana	L.
Brugmansia ×candida	Pers. (pro sp.)
Brugmansia suaveolens	(Humb. & Bonpl. ex Willd.) Bercht. & C. Presl
Brunellia comocladiifolia	Humb. & Bonpl.
Brunfelsia americana	L.
Brunfelsia densifolia	Krug & Urb.
Brunfelsia lactea	Krug & Urb.
Brunfelsia nitida	Benth.
Brunfelsia portoricensis	Krug & Urb.
Brya ebenus	(L.) DC.
Buchenavia tetraphylla	(Aubl.) Howard
Buchenavia tetraphylla	(Aubl.) R.A.Howard
Buchnera americana	L.
Buchnera longifolia	Kunth
Bucida buceras	L.
Buddleja davidii	Franch.
Buddleja madagascariensis	Lam.
Bulbophyllum pachyrachis	(A. Rich.) Griseb.
Bulbostylis antillana	(Britton) Fernald
Bulbostylis capillaris	(L.) Kunth ex C.B. Clarke
Bulbostylis curassavica	(Britton) Britton ex Kük.
Bulbostylis juncoides	(Vahl) Kük.
Bulbostylis pauciflora	(Liebm.) C.B. Clarke
Bulbostylis stenocarpa	Kük.
Bulbostylis subaphylla	C.B. Clarke
Bulbostylis vestita	(Kunth) C.B. Clarke
Bunchosia glandulifera	(Jacq.) Kunth
Bunchosia glandulosa	(Cav.) DC.
Bunchosia polystachia	(Andrews) DC.
Burmannia biflora	L.
Burmannia capitata	(J.F. Gmel.) Mart.
Bursera simaruba	(L.) Sarg.
Buxus portoricensis	Alain
Buxus vahlii	Baill.
Byrsonima crassifolia	(L.) Kunth
Byrsonima lucida	(Mill.) DC.
Byrsonima spicata	(Cav.) Kunth
Byrsonima spicata	(Cav.) Rich. ex Kunth
Byrsonima wadsworthii	Little
Cabomba furcata	Schult. & Schult. f.
Cabomba haynesii	Wiersema
Caesalpinia bonduc	(L.) Roxb.
Caesalpinia ciliata	(Bergius ex Wikstr.) Urb.
Caesalpinia coriaria	(Jacq.) Willd.
Caesalpinia culebrae	(Britton & P. Wilson) Alain
Caesalpinia decapetala	(Roth) Alston
Caesalpinia divergens	Urb.
Caesalpinia gilliesii	(Wall. ex Hook.) Wall. ex D. Dietr.
Caesalpinia major	(Medik.) Dandy & Exell
Caesalpinia monensis	Britton
Caesalpinia portoricensis	(Britton & P. Wilson) Alain
Caesalpinia pulcherrima	(L.) Sw.
Cajanus cajan	(L.) Millsp.
Cakile lanceolata	(Willd.) O.E. Schulz
Caladium bicolor	(Aiton) Vent.
Calathea allouia	(Aubl.) Lindl.
Calathea crotalifera	S. Watson
Calathea lutea	(Aubl.) Schult.
Calathea zebrina	(Sims) Lindl.
Calliandra haematomma	(Bertero ex DC.) Benth.
Calliandra locoensis	R. Garcia & D. Kolterman
Calliandra surinamensis	Benth.
Callicarpa ampla	Schauer
Callisia fragrans	(Lindl.) Woodson
Callisia monandra	(Sw.) Schult. & Schult. f.
Callisia repens	(Jacq.) L.
Callistemon citrinus	(Curtis) Skeels
Caloncoba echinata	(Oliv.) Gilg
Calophyllum antillanum	Britton
Calophyllum inophyllum	L.
Calopogonium caeruleum	(Benth.) Suav.
Calopogonium mucunoides	Desv.
Calotropis procera	(Aiton) W.T. Aiton
Calycophyllum candidissimum	(Vahl) DC.
Calyptranthes acevedoi	Alain
Calyptranthes estremenae	Alain
Calyptranthes krugii	Kiaersk.
Calyptranthes luquillensis	Alain
Calyptranthes martorellii	Alain
Calyptranthes pallens	Griseb.
Calyptranthes peduncularis	Alain
Calyptranthes portoricensis	Britton
Calyptranthes sintenisii	Kiaersk.
Calyptranthes thomasiana	Berg
Calyptranthes triflora	Alain
Calyptranthes woodburyi	Alain
Calyptranthes zuzygium	(L.) Sw.
Calyptronoma rivalis	(O.F. Cook) L.H. Bailey
Campylocentrum fasciolum	(Lindl.) Cogn.
Campylocentrum filiforme	(Sw.) Cogn. ex Kuntze
Campylocentrum micranthum	(Lindl.) Maury
Campylocentrum micranthum	(Lindl.) Rolfe
Campylocentrum pachyrrhizum	(Rchb. f.) Rolfe
Campylocentrum pygmaeum	Cogn.
Campyloneurum angustifolium	(Sw.) Fée
Campyloneurum brevifolium	(Lodd. ex Link) Link
Campyloneurum costatum	(Kunze) C. Presl
Campyloneurum latum	T. Moore
Campyloneurum phyllitidis	(L.) C. Presl
Campyloneurum repens	(Aubl.) C. Presl
Cananga odorata	(Lam.) Hook. f. & Thomson
Canavalia ensiformis	(L.) DC.
Canavalia nitida	(Cav.) Piper
Canavalia rosea	(Sw.) DC.
Canella winterana	(L.) Gaertn.
Cannabis sativa	L.
Canna glauca	L.
Canna indica	L.
Canna jaegeriana	Urb.
Canna pertusa	Urb.
Canna sylvestris	Roscoe
Caperonia palustris	(L.) A. St.-Hil.
Caperonia palustris	(L.) A.St.-Hil.
Capparis amplissima	Lam.
Capparis baducca	L.
Capparis cynophallophora	L.
Capparis flexuosa	(L.) L.
Capparis hastata	Jacq.
Capparis indica	(L.) Druce
Capraria biflora	L.
Capsicum annuum	L.
Cardamine flexuosa	With.
Cardiospermum corindum	L.
Cardiospermum halicacabum	L.
Cardiospermum microcarpum	Kunth
Carex longii	Mack.
Carex polystachya	Sw. ex Wahlenb.
Carica papaya	L.
Carissa macrocarpa	(Eckl.) A. DC.
Carludovica palmata	Ruiz & Pav.
Casearia aculeata	Jacq.
Casearia arborea	(Rich.) Urb.
Casearia decandra	Jacq.
Casearia guianensis	(Aubl.) Urb.
Casearia sylvestris	Sw.
Cassia fistula	L.
Cassia grandis	L. f.
Cassia javanica	L.
Cassine xylocarpa	Vent.
Cassipourea guianensis	Aubl.
Cassytha filiformis	L.
Castela erecta	Turp.
Castilla elastica	Sessé
Casuarina cunninghamiana	Miq.
Casuarina equisetifolia	L.
Casuarina lepidophloia	F. Muell.
Catalpa longissima	(Jacq.) Dum. Cours.
Catesbaea melanocarpa	Krug & Urb.
Catesbaea parviflora	Sw.
Catharanthus roseus	(L.) G. Don
Catopsis berteroniana	(Schult. & Schult. f.) Mez
Catopsis floribunda	L.B. Sm.
Catopsis floribunda	L.B.Sm.
Catopsis nitida	(Hook.) Griseb.
Catopsis nutans	(Sw.) Griseb.
Catopsis sessiliflora	(Ruiz & Pav.) Mez
Cayaponia americana	(Lam.) Cogn.
Cayaponia racemosa	(Mill.) Cogn.
Cecropia schreberiana	Miq.
Cedrela odorata	L.
Ceiba aesculifolia	(Kunth) Britten & Baker f.
Ceiba pentandra	(L.) Gaertn.
Celosia argentea	L.
Celosia nitida	Vahl
Celosia virgata	Jacq.
Celtis iguanaea	(Jacq.) Sarg.
Celtis trinervia	Lam.
Cenchrus brownii	Roem. & Schult.
Cenchrus echinatus	L.
Cenchrus gracillimus	Nash
Cenchrus myosuroides	Kunth
Cenchrus purpureus	(Schumach.) Morrone
Cenchrus spinifex	Cav.
Centella erecta	(L. f.) Fernald
Centratherum punctatum	Cass.
Centrosema molle	Mart. ex Benth.
Centrosema plumieri	(Turp. ex Pers.) Benth.
Centrosema pubescens	Benth.
Centrosema virginianum	(L.) Benth.
Ceratophyllum demersum	L.
Ceratopteris richardii	Brongn.
Ceratopteris thalictroides	(L.) Brongn.
Cereus hexagonus	(L.) Mill.
Cereus hildmannianus	K. Schum.
Cestrum alternifolium	(Jacq.) O.E. Schulz
Cestrum diurnum	L.
Cestrum laurifolium	L'Hér.
Cestrum macrophyllum	Vent.
Cestrum nocturnum	L.
Cestrum salicifolium	Jacq.
Chamaecrista diphylla	(L.) Greene
Chamaecrista glandulosa	(L.) Greene
Chamaecrista lineata	(Sw.) Greene
Chamaecrista nictitans	(L.) Moench
Chamaecrista portoricensis	(Urb.) O.F. Cook & G.N. Collins
Chamaecrista rotundifolia	(Pers.) Greene
Chamaesyce adenoptera	(Bertol.) Small
Chamaesyce articulata	(Burm.) Britton
Chamaesyce berteriana	(Balbis ex Spreng.) Millsp.
Chamaesyce blodgettii	(Engelm. ex Hitchc.) Small
Chamaesyce cowellii	Millsp. ex Britton
Chamaesyce hirta	(L.) Millsp.
Chamaesyce hypericifolia	(L.) Millsp.
Chamaesyce hyssopifolia	(L.) Small
Chamaesyce lasiocarpa	(Klotzsch) Arthur
Chamaesyce mesembrianthemifolia	(Jacq.) Dugand
Chamaesyce nutans	(Lag.) Small
Chamaesyce ophthalmica	(Pers.) Burch
Chamaesyce orbifolia	Alain
Chamaesyce prostrata	(Aiton) Small
Chamaesyce serpens	(Kunth) Small
Chamaesyce thymifolia	(L.) Millsp.
Chamaesyce turpinii	(Boiss.) Millsp.
Chamissoa altissima	(Jacq.) Kunth
Chaptalia albicans	(Sw.) Vent. ex Steud.
Chaptalia dentata	(L.) Cass.
Chaptalia nutans	(L.) Polak.
Cheilanthes microphylla	(Sw.) Sw.
Cheilanthes paupercula	(Kunze) Mett.
Cheilocostus speciosus	(J.Koenig) C.D.Specht
Cheiroglossa palmata	(L.) C. Presl
Chenopodium murale	L.
Chiococca alba	(L.) Hitchc.
Chiococca parvifolia	Wullschl. ex Griseb.
Chionanthus axilliflorus	(Griseb.) Stearn
Chionanthus compactus	Sw.
Chionanthus domingensis	Lam.
Chionanthus holdridgei	(Camp & Monachino) Stearn
Chionanthus ligustrinus	(Sw.) Pers.
Chione seminervis	Urb. & Ekman
Chione venosa	(Sw.) Urb.
Chloris barbata	Sw.
Chloris ciliata	Sw.
Chloris cubensis	Hitchc. & Ekman ex Hitchc.
Chloris elata	Desv.
Chloris radiata	(L.) Sw.
Chloris sagraeana	A. Rich.
Chorisia speciosa	A. St.-Hil.
Chromolaena borinquensis	(Britton) R.M. King & H. Rob.
Chromolaena corymbosa	(Aubl.) R.M. King & H. Rob.
Chromolaena geraniifolia	(Urb.) R.M. King & H. Rob.
Chromolaena ivifolia	(L.) R.M. King & H. Rob.
Chromolaena odorata	(L.) R.M. King & H. Rob.
Chromolaena oteroi	(Monachino) R.M. King & H. Rob.
Chromolaena sinuata	(Lam.) R.M. King & H. Rob.
Chrysobalanus icaco	L.
Chrysophyllum argenteum	Jacq.
Chrysophyllum cainito	L.
Chrysophyllum oliviforme	L.
Chrysophyllum pauciflorum	Lam.
Chrysothemis pulchella	(Donn ex Sims) Decne.
Chusquea abietifolia	Griseb.
Cicer arietinum	L.
Cinnamomum camphora	(L.) J. Presl
Cinnamomum elongatum	(Nees) Kosterm.
Cinnamomum elongatum	(Vahl ex Nees) Kosterm.
Cinnamomum montanum	(Sw.) Bercht. & J. Presl
Cinnamomum montanum	(Sw.) J.Presl
Cinnamomum verum	J. Presl
Cirsium mexicanum	DC.
Cissampelos pareira	L.
Cissus erosa	Rich.
Cissus intermedia	A. Rich.
Cissus obovata	Vahl
Cissus trifoliata	(L.) L.
Cissus tuberculata	Jacq.
Cissus verticillata	(L.) Nicolson & C.E.Jarvis
Cissus verticillata	(L.) Nicolson & Jarvis
Citharexylum caudatum	L.
Citharexylum ×perkinsii	Moldenke
Citharexylum spinosum	L.
Citrullus lanatus	(Thunb.) Matsum. & Nakai
Citrus ×aurantiifolia	(Christm.) Swingle (pro sp.)
Citrus ×aurantium	L. (pro sp.)
Citrus limetta	Risso
Citrus ×limonia	Osbeck (pro sp.)
Citrus ×limon	(L.) Burm. f. (pro sp.)
Citrus maxima	(Burm. f.) Merr.
Citrus medica	L.
Citrus paradisi	Macfad.
Citrus ×paradisi	Macfad. (pro sp.)
Citrus reticulata	Blanco
Citrus ×sinensis	(L.) Osbeck (pro sp.)
Citrus x aurantium	L.
Cladium colocasia	(L.) W. Wight
Cladium mariscus	(L.) Pohl
Clematis dioica	L.
Cleome aculeata	L.
Cleome gynandra	L.
Cleome hassleriana	Chod.
Cleome serrata	Jacq.
Cleome speciosa	Raf.
Cleome spinosa	Jacq.
Cleome stenophylla	Klotzsch ex Urb.
Cleome viscosa	L.
Clerodendrum aculeatum	(L.) Schltdl.
Clerodendrum bungei	Steud.
Clerodendrum chinense	(Osb.) Mabberley
Clerodendrum quadriloculare	(Blanco) Merr.
Clerodendrum speciosissimum	Van Geert ex C. Morren
Clerodendrum ×speciosum	Dombrain
Clerodendrum wallichii	Merr.
Cleyera albopunctata	(Griseb.) Krug & Urb.
Clibadium erosum	(Sw.) DC.
Clidemia angustilamina	W.S. Judd & Skean
Clidemia cymosa	(Wendl. ex Spreng.) Alain
Clidemia eggersii	(Cogn.) F.S.Axelrod
Clidemia hirta	(L.) D. Don
Clidemia strigillosa	(Sw.) DC.
Clitoria fairchildiana	Howard
Clitoria falcata	Lam.
Clitoria laurifolia	Poir.
Clitoria ternatea	L.
Clusia clusioides	(Griseb.) D'Arcy
Clusia gundlachii	Stahl
Clusia minor	L.
Clusia rosea	Jacq.
Cnemidaria horrida	(L.) C. Presl
Cnidoscolus aconitifolius	(Mill.) I.M. Johnst.
Coccocypselum herbaceum	Aubl.
Coccoloba costata	C. Wright ex Sauvalle
Coccoloba diversifolia	Jacq.
Coccoloba krugii	Lindau
Coccoloba microstachya	Willd.
Coccoloba pallida	C. Wright
Coccoloba pubescens	L.
Coccoloba pyrifolia	Desf.
Coccoloba rugosa	Desf.
Coccoloba sintenisii	Urb. ex Lindau
Coccoloba swartzii	Meisn.
Coccoloba tenuifolia	L.
Coccoloba uvifera	(L.) L.
Coccoloba venosa	L.
Coccothrinax barbadensis	(Lodd. ex Mart.) Becc.
Cochleanthes flabelliformis	(Sw.) R.E. Schult. & Garay
Cochleanthes flabelliformis	(Sw.) R.E.Schult. & Garay
Cochlidium jungens	Bishop
Cochlidium rostratum	(Hook.) Maxon ex C. Chr.
Cochlidium seminudum	(Willd.) Maxon
Cochlidium serrulatum	(Sw.) Bishop
Cochlidium serrulatum	(Sw.) L.E. Bishop
Cochlospermum vitifolium	(Willd.) Willd. ex Spreng.
Cocos nucifera	L.
Codariocalyx gyroides	(Roxb. ex Link) Hassk.
Codiaeum variegatum	(L.) A. Juss.
Codiaeum variegatum	(L.) Rumph. ex A.Juss.
Coffea arabica	L.
Coffea liberica	W. Bull ex Hiern.
Coix lacryma-jobi	L.
Cojoba arborea	(L.) Britton & Rose
Cola acuminata	(P. Beauv.) Schott & Endl.
Colocasia esculenta	(L.) Schott
Colubrina arborescens	(Mill.) Sarg.
Colubrina elliptica	(Sw.) Briz. & Stern
Colubrina glandulosa	Perkins
Colubrina verrucosa	(Urb.) M.C. Johnst.
Columnea ambigua	(Urb.) B.D.Morley
Columnea ambigua	(Urb.) Morley
Columnea scandens	L.
Commelina benghalensis	L.
Commelina diffusa	Burm. f.
Commelina diffusa	Burm.f.
Commelina erecta	L.
Commelina rufipes	Seub.
Commelina rufipes	Seubert
Commelina virginica	L.
Comocladia dodonaea	(L.) Urb.
Comocladia glabra	(Schult.) Spreng.
Comparettia falcata	Poepp. & Endl.
Condylidium iresinoides	(Kunth) R.M. King & H. Rob.
Congea tomentosa	Roxb.
Conocarpus erectus	L.
Conostegia rufescens	Naud.
Consolea moniliformis	(L.) Britton
Consolea rubescens	(Salm-Dyck ex DC.) Lem.
Convolvulus nodiflorus	Desv.
Conyza canadensis	(L.) Cronquist
Conyza floribunda	Kunth
Conyza laevigata	(L.C. Rich) Pruski
Conyza primulifolia	(Lam.) Cuatrec. & Lourteig
Copaifera officinalis	(Jacq.) L.
Corchorus aestuans	L.
Corchorus hirsutus	L.
Corchorus hirtus	L.
Corchorus siliquosus	L.
Cordia alliodora	(Ruiz & Pav.) Oken
Cordia angustifolia	(West ex Willd.) Roem. & Schult.
Cordia bahamensis	Urb.
Cordia bellonis	Urb.
Cordia borinquensis	Urb.
Cordia collococca	L.
Cordia gerascanthus	L.
Cordia globosa	(Jacq.) Kunth
Cordia laevigata	Lam.
Cordia lima	(Desv.) Roem. & Schult.
Cordia obliqua	Willd.
Cordia polycephala	(Lam.) I.M. Johnst.
Cordia rickseckeri	Millsp.
Cordia rupicola	Urb.
Cordia sebestena	L.
Cordia sulcata	A.DC.
Cordia sulcata	DC.
Cordia wagneriorum	Howard
Cordyline fruticosa	(L.) A. Chev
Cordyline fruticosa	(L.) A.Chev.
Coriandrum sativum	L.
Cornutia obovata	Urb.
Cornutia pyramidata	L.
Coronopus didymus	(L.) Sm.
Corymbia citriodora	(Hook.) K.D. Hill & L.A.S. Johnson
Corymborkis forcipigera	(Rchb. f. & Warszewicz) L.O. Williams
Cosmos caudatus	Kunth
Cosmos sulphureus	Cav.
Costus guanaiensis	Rusby
Costus malortieanus	H. Wendl.
Costus scaber	Ruiz & Pav.
Costus speciosus	(J. Koenig) Sm.
Costus spicatus	(Jacq.) Sw.
Couroupita guianensis	Aubl.
Coursetia caribaea	(Jacq.) Lavin
Cranichis muscosa	Sw.
Cranichis ricartii	Ackerman
Craniolaria annua	L.
Crassocephalum crepidioides	(Benth.) S. Moore
Crescentia alata	Kunth
Crescentia cujete	L.
Crescentia linearifolia	Miers
Crescentia portoricensis	Britton
Crinum zeylanicum	(L.) L.
Critonia aromatisans	(DC.) R.M.King & H.Rob.
Critonia portoricensis	(Urb.) Britton & P. Wilson
Crocosmia ×crocosmiiflora	(V. Lemoine) N.E. Br.
Crossopetalum rhacoma	Crantz
Crotalaria berteriana	DC.
Crotalaria brevidens	Benth.
Crotalaria incana	L.
Crotalaria juncea	L.
Crotalaria lotifolia	L.
Crotalaria micans	Link
Crotalaria pallida	Aiton
Crotalaria retusa	L.
Crotalaria rotundifolia	Walter ex J.F. Gmel.
Crotalaria sagittalis	L.
Crotalaria saltiana	Andrews
Crotalaria spectabilis	Roth
Crotalaria stipularia	Desv.
Crotalaria trichotoma	Bojer
Crotalaria verrucosa	L.
Croton astroites	Dryand.
Croton betulinus	Vahl
Croton discolor	Willd.
Croton flavens	L.
Croton glandulosus	L.
Croton humilis	L.
Croton impressus	Urb.
Croton lobatus	L.
Croton lucidus	L.
Croton nummulariifolius	A. Rich.
Croton ovalifolius	Vahl
Croton poecilanthus	Urb.
Croton stenophyllus	Griseb.
Cryptostegia grandiflora	(Roxb. ex R. Br.) R. Br.
Cryptostegia madagascariensis	Bojer ex Decne.
Ctenitis hirta	(Sw.) Ching
Ctenitis nemorosa	(Humb. & Bonpl. ex Willd.) Ching
Cucumis anguria	L.
Cucumis melo	L.
Cucumis sativus	L.
Cucurbita maxima	Duchesne
Cucurbita moschata	Duchesne
Cucurbita pepo	L.
Cupania americana	L.
Cupania triquetra	A. Rich.
Cuphea hyssopifolia	Kunth
Cuphea micrantha	Kunth
Cuphea parsonsia	(L.) R. Br. ex Steud.
Cuphea strigulosa	Kunth
Curculigo capitulata	(Lour.) Kuntze
Curculigo scorzonerifolia	(Lam.) Baker
Curcuma longa	L.
Cuscuta americana	L.
Cuscuta boldinghii	Urb.
Cuscuta globulosa	Benth.
Cuscuta indecora	Choisy
Cuscuta obtusiflora	Kunth
Cuscuta pentagona	Engelm.
Cuscuta umbellata	Kunth
Cyanthillium cinereum	(L.) H. Rob.
Cyanthillium cinereum	(L.) H.Rob.
Cyathea andina	(Karst.) Domin
Cyathea arborea	(L.) Sm.
Cyathea armata	(Sw.) Domin
Cyathea borinquena	(Maxon) Domin
Cyathea furfuracea	Baker
Cyathea horrida	(L.) Sm.
Cyathea parvula	(Jenman) Domin
Cyathea pungens	(Willd.) Domin
Cyathea tenera	(J. Sm. ex Hook.) T. Moore
Cyathula prostrata	(L.) Blume
Cybianthus sintenisii	(Urb.) G. Agostini
Cycas circinalis	L.
Cycas revoluta	Thunb.
Cyclopeltis semicordata	(Sw.) J. Sm.
Cyclopogon cranichoides	(Griseb.) Schltr.
Cyclopogon elatus	(Sw.) Schltr.
Cyclopogon miradorense	Schltr.
Cyclospermum leptophyllum	(Pers.) Sprague
Cyclospermum leptophyllum	(Pers.) Sprague ex Britton & P. Wilson
Cydista aequinoctialis	(L.) Miers
Cymbocarpa refracta	Miers
Cymbopogon citratus	(DC. ex Nees) Stapf
Cymbopogon nardus	(L.) Rendle
Cymodocea filiformis	(Kütz.) Correll
Cynanchum anegadense	(Britton) Alain
Cynanchum cheesmanii	Woodson
Cynanchum cubense	(A. Rich.) Woodson
Cynanchum ephedroides	(Griseb.) Alain
Cynanchum grisebachianum	(Schltr.) Alain
Cynanchum lineare	(Bello) Alain, nom. inq.
Cynanchum monense	(Britton) Alain
Cynanchum parviflorum	Sw.
Cynodon dactylon	(L.) Pers.
Cynodon nlemfuensis	Vanderyst
Cynoglossum amabile	Stapf & J.R. Drumm.
Cynoglossum furcatum	Wall. ex Roxb.
Cynometra portoricensis	Krug & Urb.
Cyperus aggregatus	(Willd.) Endl.
Cyperus articulatus	L.
Cyperus calcicola	Britton
Cyperus compressus	L.
Cyperus confertus	Sw.
Cyperus croceus	Vahl
Cyperus difformis	L.
Cyperus digitatus	Roxb.
Cyperus distans	L. f.
Cyperus elegans	L.
Cyperus entrerianus	Boeckeler
Cyperus esculentus	L.
Cyperus filiformis	Sw.
Cyperus flavescens	L.
Cyperus flexuosus	Vahl
Cyperus floridanus	Britton
Cyperus fuligineus	Chapm.
Cyperus giganteus	Vahl
Cyperus haspan	L.
Cyperus imbricatus	Retz.
Cyperus involucratus	Rottb.
Cyperus iria	L.
Cyperus laevigatus	L.
Cyperus ligularis	L.
Cyperus mutisii	(Kunth) Griseb.
Cyperus nanus	Willd.
Cyperus ochraceus	Vahl
Cyperus odoratus	L.
Cyperus papyrus	L.
Cyperus planifolius	Rich.
Cyperus polystachyos	Rottb.
Cyperus pulguerensis	M.T. Strong
Cyperus rotundus	L.
Cyperus sphacelatus	Rottb.
Cyperus surinamensis	Rottb.
Cyperus swartzii	(A. Dietr.) Boeckeler ex Kük.
Cyperus tenuis	Sw.
Cyperus unioloides	R. Br.
Cyperus urbanii	Boeckeler
Cyperus virens	Michx.
Cypselea humifusa	Turp.
Cyrilla racemiflora	L.
Cyrtopodium punctatum	(L.) Lindl.
Dacryodes excelsa	Vahl
Dactylis glomerata	L.
Dactyloctenium aegyptium	(L.) Willd.
Dalbergia ecastaphyllum	(L.) Taubert
Dalbergia monetaria	L. f.
Dalbergia monetaria	L.f.
Dalbergia sissoo	DC.
Dalbergia sissoo	Roxb. ex DC.
Dalea carthagenensis	(Jacq.) J.F. Macbr.
Dalechampia scandens	L.
Danaea elliptica	Sm.
Danaea geniculata	Raddi
Danaea grandifolia	Underw.
Danaea jamaicensis	Underw.
Danaea jenmanii	Underw.
Danaea nodosa	(L.) Sm.
Danaea urbanii	Maxon
Daphnopsis americana	(Mill.) J.R. Johnst.
Daphnopsis helleriana	Urb.
Daphnopsis philippiana	Krug & Urb.
Datura inoxia	Mill.
Datura stramonium	L.
Datura wrightii	Regel
Daucus carota	L.
Delonix regia	(Bojer ex Hook.) Raf.
Dendropanax arboreus	(L.) Decne. & Planch.
Dendropanax arboreus	(L.) Decne. & Planch. ex Britton
Dendropanax laurifolius	(Marchal ex Urb.) R.C. Schneid.
Dendropemon bicolor	Krug & Urb.
Dendropemon caribaeus	Krug & Urb.
Dendropemon purpureus	(L.) Krug & Urb.
Dendropemon sintenisii	Krug & Urb.
Dendrophthora domingensis	(Spreng.) Eichl.
Dendrophthora flagelliformis	(Lam.) Krug & Urb.
Dendrophthora serpyllifolia	(Griseb.) Krug & Urb.
Dennstaedtia bipinnata	(Cav.) Maxon
Dennstaedtia cicutaria	(Sw.) T. Moore
Dennstaedtia dissecta	(Sw.) T. Moore
Dennstaedtia globulifera	(Poir.) Hieron.
Dennstaedtia obtusifolia	(Willd.) T. Moore
Desmanthus leptophyllus	Kunth
Desmanthus pernambucanus	(L.) Thell.
Desmanthus virgatus	(L.) Willd.
Desmodium adscendens	(Sw.) DC.
Desmodium affine	Schltdl.
Desmodium axillare	(Sw.) DC.
Desmodium barbatum	(L.) Benth.
Desmodium cubense	Griseb.
Desmodium glabrum	(Mill.) DC.
Desmodium incanum	DC.
Desmodium intortum	(Mill.) Urb.
Desmodium procumbens	(Mill.) Hitchc.
Desmodium scorpiurus	(Sw.) Desv.
Desmodium tortuosum	(Sw.) DC.
Desmodium triflorum	(L.) DC.
Desmodium wydlerianum	Urb.
Dichaea hystricina	Rchb. f.
Dichaea hystricina	Rchb.f.
Dichaea latifolia	Lindl.
Dichaea pendula	(Aubl.) Cogn.
Dichanthelium aciculare	(Desv. ex Poir.) Gould & C.A. Clark
Dichanthelium acuminatum	(Sw.) Gould & C.A. Clark
Dichanthelium dichotomum	(L.) Gould
Dichanthelium leucothrix	(Nash) Freckmann
Dichanthelium ovale	(Elliott) Gould & C.A. Clark
Dichanthelium sabulorum	(Lam.) Gould & C.A. Clark
Dichanthelium scoparium	(Lam.) Gould
Dichanthelium strigosum	(Muhl. ex Elliott) Freckmann
Dichanthium annulatum	(Forssk.) Stapf
Dichanthium aristatum	(Poir.) C.E. Hubbard
Dichondra micrantha	Urb.
Dicliptera krugii	Urb.
Dicliptera martinicensis	(Jacq.) Juss.
Dicliptera sexangularis	(L.) Juss.
Dicranopteris flexuosa	(Schrad.) Underw.
Dicranopteris pectinata	(Willd.) Underw.
Dicranopteris rubiginosa	(Mett.) Maxon
Didymoglossum angustifrons	Fée
Didymoglossum krausii	(Hook. & Grev.) C. Presl
Didymoglossum punctatum	(Poir.) Desv.
Diectomis fastigiata	(Sw.) P. Beauv.
Dieffenbachia seguine	(Jacq.) Schott
Digitaria argillacea	(Hitchc. & Chase) Fernald
Digitaria bicornis	(Lam.) Roem. & Schult.
Digitaria ciliaris	(Retz.) Koeler
Digitaria dolichophylla	Henr.
Digitaria eriantha	Steud.
Digitaria horizontalis	Willd.
Digitaria insularis	(L.) Mez ex Ekman
Digitaria ischaemum	(Schreb.) Schreb. ex Muhl.
Digitaria longiflora	(Retz.) Pers.
Digitaria nuda	Schumach.
Digitaria panicea	(Sw.) Urb.
Digitaria sanguinalis	(L.) Scop.
Digitaria setigera	Roth
Digitaria setigera	Roth ex Roem. & Schult.
Digitaria similis	Beetle ex Gould
Digitaria villosa	(Walter) Pers.
Digitaria violascens	Link
Dillenia indica	L.
Dilomilis montana	(Sw.) Summerhayes
Dioclea hexandra	(Ralph) Mabberley
Diodia apiculata	(Willd. ex Roem. & Schult.) K. Schum.
Diodia ocymifolia	(Willd. ex Roem. & Schult.) Bremek.
Diodia sarmentosa	Sw.
Diodia serrulata	(P. Beauv.) G. Taylor
Dioscorea alata	L.
Dioscorea altissima	Lam.
Dioscorea bulbifera	L.
Dioscorea cayenensis	Lam.
Dioscorea esculenta	(Lour.) Burkill
Dioscorea pilosiuscula	Bertero ex Spreng.
Dioscorea polygonoides	Humb. & Bonpl. ex Willd.
Dioscorea rotundata	Poir.
Dioscorea trifida	L. f.
Dioscorea villosa	L.
Diospyros revoluta	Poir.
Diospyros sintenisii	(Krug & Urb.) Standl.
Diplazium centripetale	(Baker) Maxon
Diplazium cristatum	(Desr.) Alston
Diplazium expansum	Willd.
Diplazium grandifolium	(Sw.) Sw.
Diplazium hymenodes	(Mett.) Á. Löve & D. Löve
Diplazium lherminieri	Hieron.
Diplazium plantaginifolium	(L.) Urb.
Diplazium riedelianum	(Bong. ex Kunze) C. Presl
Diplazium striatum	(L.) C. Presl
Diplazium unilobum	(Poir.) Hieron.
Dissotis rotundifolia	(Sm.) Triana
Distictis lactiflora	(Vahl) DC.
Ditta myricoides	Griseb.
Dodonaea viscosa	(L.) Jacq.
Dolichandra unguis-cati	(L.) L.G.Lohmann
Doliocarpus major	J.F. Gmel.
Doliocarpus olivaceus	Sprague & R.O. Williams ex Standl.
Domingoa haematochila	(Rchb. f.) Carabia
Dorstenia contrajerva	L.
Doryopteris pedata	(L.) Fée
Dovyalis hebecarpa	(G. Gardn.) Warb.
Doyerea emetocathartica	Gros.
Dracaena fragrans	(L.) Ker Gawl.
Dracontium asperum	K. Koch
Dracontium polyphyllum	L.
Dracunculus vulgaris	Schott
Drosera capillaris	Poir.
Drymaria cordata	(L.) Willd. ex Schult.
Drypetes alba	Poit.
Drypetes glauca	Vahl
Drypetes ilicifolia	(DC.) Krug & Urb.
Drypetes lateriflora	(Sw.) Krug & Urb.
Duranta erecta	L.
Dypsis lutescens	(H. Wendl.) Beentje & Dransf.
Dysphania ambrosioides	(L.) Mosyakin & Clemants
Echinochloa colona	(L.) Link
Echinochloa crus-galli	(L.) P. Beauv.
Echinochloa crus-pavonis	(Kunth) Schult.
Echinochloa polystachya	(Kunth) Hitchc.
Echinochloa stagnina	(Retz.) P. Beauv.
Echinodorus berteroi	(Spreng.) Fassett
Echinodorus bolivianus	(Rusby) Holm-Niesen
Echinodorus tenellus	(Mart. ex Schult. f.) Buchenau
Eclipta prostrata	(L.) L.
Egeria densa	Planch.
Eichhornia azurea	(Sw.) Kunth
Eichhornia crassipes	(Mart.) Solms
Eichhornia diversifolia	(Vahl) Urb.
Elaphoglossum apodum	(Kaulf.) Schott ex J. Sm.
Elaphoglossum chartaceum	(Baker ex Jenman) C. Chr.
Elaphoglossum crinitum	(L.) Christ
Elaphoglossum decoratum	(Kunze) T. Moore
Elaphoglossum eggersii	(Baker) Christ
Elaphoglossum erinaceum	(Fée) T. Moore
Elaphoglossum glabellum	J. Sm.
Elaphoglossum herminieri	(Bory ex Fée) T. Moore
Elaphoglossum herminieri	(Bory & Fée) T. Moore
Elaphoglossum latifolium	(Sw.) J. Sm.
Elaphoglossum longifolium	(C. Presl) J. Sm.
Elaphoglossum martinicense	(Desv.) T. Moore
Elaphoglossum maxonii	Underw. ex Maxon
Elaphoglossum maxonii	Underw. ex Morton
Elaphoglossum peltatum	(Sw.) Urb.
Elaphoglossum petiolatum	(Sw.) Urb.
Elaphoglossum piloselloides	(C. Presl) T. Moore
Elaphoglossum rigidum	(Aubl.) Urb.
Elaphoglossum serpens	Maxon & Morton ex Maxon
Elaphoglossum simplex	(Sw.) Schott ex J. Sm.
Elaphoglossum smithii	(Baker) Christ
Elaphoglossum spathulatum	(Bory) T. Moore
Eleocharis cellulosa	Torr.
Eleocharis debilis	Kunth
Eleocharis elegans	(Kunth) Roem. & Schult.
Eleocharis fallax	Weath.
Eleocharis flavescens	(Poir.) Urb.
Eleocharis geniculata	(L.) Roem. & Schult.
Eleocharis interstincta	(Vahl) Roem. & Schult.
Eleocharis microcarpa	Torr.
Eleocharis montana	(Kunth) Roem. & Schult.
Eleocharis mutata	(L.) Roem. & Schult.
Eleocharis oligantha	Clarke
Eleocharis olivacea	Torr.
Eleocharis pachycarpa	Desv.
Eleocharis pachystyla	(C. Wright) C.B. Clarke
Eleocharis radicans	(A. Dietr.) Kunth
Eleocharis retroflexa	(Poir.) Urb.
Eleocharis rostellata	(Torr.) Torr.
Elephantopus mollis	Kunth
Eleusine indica	(L.) Gaertn.
Eleutheranthera ruderalis	(Sw.) Sch. Bip.
Eleutherine bulbosa	(Mill.) Urb.
Elleanthus cordidactylus	Ackerman
Elodea canadensis	Michx.
Eltroplectris calcarata	(Sw.) Garay & H.R. Sweet
Emilia coccinea	(Sims) G. Don
Emilia fosbergii	Nicolson
Emilia sonchifolia	(L.) DC.
Encyclia gravida	(Lindl.) Schltr.
Encyclia isochila	(Rchb. f.) D. Dod
Enicostema verticillatum	(L.) Engl. ex Gilg
Entada polystachya	(L.) DC.
Enterolobium cyclocarpum	(Jacq.) Griseb.
Enterosora trifurcata	(L.) Bishop
Enydra sessilis	(Sw.) DC.
Epidendrum anceps	Jacq.
Epidendrum angustilobum	Fawc. & Rendle
Epidendrum antillanum	Ackerman & Hágsater
Epidendrum boricuarum	Hágsater & L.Sánchez
Epidendrum boricuarum	Hágsater & Sánchez
Epidendrum carpophorum	B. Rodrigues
Epidendrum ciliare	L.
Epidendrum jamaicense	Lindl.
Epidendrum miserrimum	Rchb. f.
Epidendrum mutelianum	Cogn.
Epidendrum nocturnum	Jacq.
Epidendrum portoricense	Hágsater & Ackerman
Epidendrum radicans	Pav. ex Lindl.
Epidendrum ramosum	Jacq.
Epidendrum rigidum	Jacq.
Epidendrum secundum	Jacq.
Epidendrum tridens	Poepp. & Endl.
Epidendrum vicentinum	Lindl.
Epiphyllum hookeri	(Link & Otto) Haw.
Epiphyllum oxypetalum	(DC.) Haw.
Epipremnum pinnatum	(L.) Engl.
Episcia cupreata	(Hook.) Hanst.
Eragrostis amabilis	(L.) Wight & Arn. ex Nees
Eragrostis barrelieri	Daveau
Eragrostis ciliaris	(L.) R. Br.
Eragrostis curvula	(Schrad.) Nees
Eragrostis elliottii	S. Watson
Eragrostis glutinosa	(Sw.) Trin.
Eragrostis hypnoides	(Lam.) Britton, Sterns & Poggenb.
Eragrostis pectinacea	(Michx.) Nees ex Steud.
Eragrostis pilosa	(L.) P. Beauv.
Eragrostis urbaniana	Hitchc.
Erechtites hieraciifolius	(L.) Raf. ex DC.
Erechtites valerianifolius	(Link ex Spreng.) DC.
Eremochloa ophiuroides	(Munro) Hack.
Erigeron bellioides	DC.
Erigeron cuneifolius	DC.
Erigeron jamaicensis	L.
Eriobotrya japonica	(Thunb.) Lindl.
Eriochloa polystachya	Kunth
Eriochloa punctata	(L.) Desv. ex Ham.
Eriochrysis cayennensis	P. Beauv.
Eriosema crinitum	(Kunth) G. Don
Eriosorus hispidulus	(Kunze) Vareschi
Erithalis fruticosa	L.
Erithalis odorifer	Jacq.
Ernodea littoralis	Sw.
Erpodium domingense	(Spreng.) Brid. ex Müll. Hal.
Eryngium foetidum	L.
Erythrina berteriana	Urb.
Erythrina corallodendron	L.
Erythrina crista-galli	L.
Erythrina eggersii	Krukoff & Moldenke
Erythrina fusca	Lour.
Erythrina poeppigiana	(Walp.) O.F. Cook
Erythrina variegata	L.
Erythrodes hirtella	(Sw.) Fawc. & Rendle
Erythrodes plantaginea	(L.) Fawc. & Rendle
Erythroxylum areolatum	L.
Erythroxylum brevipes	DC.
Erythroxylum rotundifolium	Lunan
Erythroxylum rufum	Cav.
Erythroxylum urbanii	O.E. Schulz
Etlingera elatior	(Jack) R.M. Sm.
Etlingera elatior	(Jack) R.M.Sm.
Eubrachion ambiguum	(Hook. & Arn.) Engl.
Eucalyptus camaldulensis	Dehnh.
Eucalyptus deglupta	Blume
Eucalyptus resinifera	Sm.
Eucalyptus robusta	Sm.
Eucharis amazonica	Linden ex Planch.
Euclasta condylotricha	(Hochst. ex Steud.) Stapf
Eugenia axillaris	(Sw.) Willd.
Eugenia bellonis	Krug & Urb.
Eugenia biflora	(L.) DC.
Eugenia boqueronensis	Britton
Eugenia borinquensis	Britton
Eugenia cacuminis	Alain
Eugenia confusa	DC.
Eugenia cordata	(Sw.) DC.
Eugenia corozalensis	Britton
Eugenia domingensis	Berg
Eugenia domingensis	O.Berg
Eugenia eggersii	Kiaersk.
Eugenia fajardensis	(Krug & Urb.) Urb.
Eugenia foetida	Pers.
Eugenia glabrata	(Sw.) DC.
Eugenia haematocarpa	Alain
Eugenia laevis	Berg
Eugenia ligustrina	(Sw.) Willd.
Eugenia monticola	(Sw.) DC.
Eugenia padronii	Alain
Eugenia procera	(Sw.) Poir.
Eugenia pseudopsidium	Jacq.
Eugenia rhombea	(Berg) Krug & Urb.
Eugenia serrasuela	Krug & Urb.
Eugenia sessiliflora	Vahl
Eugenia stahlii	(Kiaersk.) Krug & Urb.
Eugenia stewardsonii	Britton
Eugenia underwoodii	Britton
Eugenia uniflora	L.
Eugenia woodburyana	Alain
Eugenia xerophytica	Britton
Eulophia alta	(L.) Fawc. & Rendle
Eupatorium ×pinnatifidum	Elliott
Eupatorium triplinerve	Vahl
Euphorbia cotinifolia	L.
Euphorbia cyathophora	Murray
Euphorbia heterophylla	L.
Euphorbia hyssopifolia	L.
Euphorbia lactea	Haw.
Euphorbia lasiocarpa	Klotzsch
Euphorbia leucocephala	Lotsy
Euphorbia milii	Des Moul.
Euphorbia neriifolia	L.
Euphorbia oerstediana	(Klotzsch & Garcke) Boiss.
Euphorbia petiolaris	Sims
Euphorbia pulcherrima	Willd. ex Klotzsch
Euphorbia tirucalli	L.
Eurystyles ananassocomos	(Rchb. f.) Schltr.
Eustachys petraea	(Sw.) Desv.
Evolvulus alsinoides	(L.) L.
Evolvulus convolvuloides	(Willd. ex Schult.) Stearn
Evolvulus grisebachii	Peter
Evolvulus nummularius	(L.) L.
Evolvulus sericeus	Sw.
Exostema caribaeum	(Jacq.) Schult.
Exostema ellipticum	Griseb.
Exothea paniculata	(Juss.) Radlk.
Fadyenia hookeri	(Sweet) Maxon
Faramea occidentalis	(L.) A. Rich.
Faramea occidentalis	(L.) A.Rich.
Fatoua villosa	(Thunb.) Nakai
Fevillea cordifolia	L.
Ficus americana	Aubl.
Ficus benjamina	L.
Ficus carica	L.
Ficus citrifolia	Mill.
Ficus drupacea	Thunb.
Ficus elastica	Roxb. ex Hornem.
Ficus lutea	Vahl
Ficus lyrata	Warb.
Ficus microcarpa	L. f.
Ficus pumila	L.
Ficus religiosa	L.
Ficus stahlii	Warb.
Ficus thonningii	Blume
Ficus trigonata	L.
Fimbristylis complanata	(Retz.) Link
Fimbristylis cymosa	R. Br.
Fimbristylis dichotoma	(L.) Vahl
Fimbristylis ferruginea	(L.) Vahl
Fimbristylis littoralis	Gaudich.
Fimbristylis quinquangularis	(Vahl) Kunth
Fimbristylis spadicea	(L.) Vahl
Fioria vitifolia	(L.) Mattei
Flacourtia indica	(Burm. f.) Merr.
Flacourtia inermis	Roxb.
Flaveria bidentis	(L.) Kuntze
Flaveria trinervia	(Spreng.) C. Mohr
Fleischmannia microstemon	(Cass.) R.M. King & H. Rob.
Fleischmannia microstemon	(Cass.) R.M.King & H.Rob.
Flemingia strobilifera	(L.) W.T. Aiton
Flueggea acidoton	(L.) G.L. Webster
Flueggea virosa	(Roxb. ex Willd.) Voigt
Foeniculum vulgare	Mill.
Forchhammeria brevipes	Urb.
Forchhammeria polyandra	(Griseb.) Alain
Forestiera eggersiana	Krug & Urb.
Forestiera rhamnifolia	Griseb.
Forestiera segregata	(Jacq.) Krug & Urb.
Forsteronia corymbosa	(Jacq.) G. Mey.
Fortunella margarita	(Lour.) Swingle
Frangula sphaerosperma	(Sw.) Kartesz & Gandhi
Fraxinus uhdei	(Wenzig) Lingelsh.
Fuirena robusta	Kunth
Fuirena umbellata	Rottb.
Funtumia elastica	(Preuss) Stapf
Furcraea antillana	A. Álvarez
Furcraea tuberosa	(Mill.) W.T. Aiton
Galactia dubia	DC.
Galactia longifolia	(Jacq.) Benth. ex Hoehne
Galactia striata	(Jacq.) Urb.
Galeandra beyrichii	Rchb. f.
Galinsoga parviflora	Cav.
Galinsoga quadriradiata	Cav.
Galphimia gracilis	Bartlett
Gamochaeta americana	(Mill.) Weddell
Gamochaeta argyrinea	G.L. Nesom
Garcinia dulcis	(Roxb.) Kurz
Garcinia hessii	(Britton) Alain
Garcinia mangostana	L.
Garcinia portoricensis	(Urb.) Alain
Gardenia jasminoides	Ellis
Gaussia attenuata	(O.F. Cook) Becc.
Genipa americana	L.
Geophila repens	(L.) I.M. Johnst.
Gesneria citrina	Urb.
Gesneria cuneifolia	(DC.) Fritsch
Gesneria pauciflora	Urb.
Gesneria pedunculosa	(DC.) Fritsch
Gesneria reticulata	(Griseb.) Urb.
Gesneria viridiflora	(Decne.) Kuntze
Gibasis geniculata	(Jacq.) Rohw.
Ginoria rohrii	(Vahl) Koehne
Glandularia bipinnatifida	(Nutt.) Nutt.
Glandularia pulchella	(Sweet) Troncoso
Gleichenella pectinata	(Willd.) Ching
Gliricidia sepium	(Jacq.) Kunth ex Walp.
Gloxinia perennis	(L.) Fritsch
Glycine max	(L.) Merr.
Gmelina arborea	Roxb.
Gmelina asiatica	L.
Gnaphalium polycaulon	Pers.
Goetzea elegans	Wydler
Gomidesia lindeniana	Berg
Gomphrena globosa	L.
Gomphrena serrata	L.
Gonocalyx concolor	Nevl.
Gonocalyx portoricensis	(Urb.) A.C. Sm.
Gonolobus stephanotrichus	Griseb.
Gonzalagunia hirsuta	(Jacq.) K. Schum.
Gonzalagunia spicata	(Lam.) M.Gómez
Gossypium barbadense	L.
Gossypium hirsutum	L.
Gouania lupuloides	(L.) Urb.
Gouania polygama	(Jacq.) Urb.
Govenia floridana	P.M. Brown
Graffenrieda ottoschulzii	(Urb. & Ekman) Urb. & Ekman
Grammitis aspleniifolia	(L.) Proctor
Grammitis cultrata	(Willd.) Proctor
Grammitis hanekeana	Proctor
Grammitis hessii	(Maxon) Alain
Grammitis liogieri	Proctor
Grammitis mollissima	(Fée) Proctor
Grammitis sherringii	(Baker) Proctor
Grammitis taxifolia	(L.) Proctor
Grammitis trichomanoides	(Sw.) Ching
Graptophyllum pictum	(L.) Griff.
Grevillea robusta	A. Cunn. ex R. Br.
Guaiacum officinale	L.
Guaiacum sanctum	L.
Guapira discolor	(Spreng.) Little
Guapira fragrans	(Dum. Cours.) Little
Guapira obtusata	(Jacq.) Little
Guarea glabra	Vahl
Guarea guidonia	(L.) Sleumer
Guatteria blainii	(Griseb.) Urb.
Guatteria caribaea	Urb.
Guazuma ulmifolia	Lam.
Guettarda elliptica	Sw.
Guettarda krugii	Urb.
Guettarda odorata	(Jacq.) Lam.
Guettarda ovalifolia	Urb.
Guettarda pungens	Urb.
Guettarda scabra	(L.) Vent.
Guettarda valenzuelana	A. Rich.
Guettarda valenzuelana	A.Rich.
Gundlachia corymbosa	(Urb.) Britton ex Boldingh
Guzmania berteroniana	(Schult. & Schult. f.) Mez
Guzmania lingulata	(L.) Mez
Guzmania monostachia	(L.) Rusby ex Mez
Gyminda latifolia	(Sw.) Urb.
Gymnanthes lucida	Sw.
Gymnopogon foliosus	(Willd.) Nees
Gymnosiphon niveus	(Griseb.) Urb.
Gymnosiphon sphaerocarpus	Urb.
Gynerium sagittatum	(Aubl.) P. Beauv.
Habenaria alata	Hook.
Habenaria amalfitana	Lehm. & Kränzlin
Habenaria distans	Griseb.
Habenaria eustachya	Rchb. f.
Habenaria monorrhiza	(Sw.) Rchb. f.
Habenaria odontopetala	Rchb. f.
Habenaria repens	Nutt.
Hackelochloa granularis	(L.) Kuntze
Haematoxylum campechianum	L.
Haenianthus salicifolius	Griseb.
Halodule wrightii	Asch.
Halophila baillonis	Asch.
Halophila decipiens	Ostenf.
Hamelia axillaris	Sw.
Hamelia patens	Jacq.
Hapalorchis lineatus	(Lindl.) Schltr.
Harrisella porrecta	(Rchb. f.) Fawc. & Rendle
Harrisia portoricensis	Britton
Hebeclinium macrophyllum	(L.) DC.
Hebestigma cubense	(Kunth) Urb.
Hecistopteris pumila	(Spreng.) J. Sm.
Hedychium coronarium	J.Koenig
Hedychium coronarium	J. Koenig
Hedychium flavescens	Carey ex Roscoe
Hedyosmum arborescens	Sw.
Helianthus annuus	L.
Heliconia bihai	(L.) L.
Heliconia caribaea	Lam.
Heliconia psittacorum	L. f.
Heliconia psittacorum	L.f.
Heliconia rostrata	Ruiz & Pav.
Heliconia stricta	Huber
Heliconia subulata	Ruiz & Pav.
Helicteres jamaicensis	Jacq.
Heliotropium amplexicaule	Vahl
Heliotropium angiospermum	Murray
Heliotropium arborescens	L.
Heliotropium curassavicum	L.
Heliotropium fruticosum	L.
Heliotropium guanicense	Urb.
Heliotropium indicum	L.
Heliotropium lagoense	(Warm.) Guerke
Heliotropium microphyllum	Sw. ex Wikstr.
Heliotropium procumbens	Mill.
Heliotropium ternatum	Vahl
Helleriella punctulata	(Rchb. f.) Garay & H.R. Sweet
Hemidictyum marginatum	(L.) C. Presl
Hemigraphis alternata	(Burm. f.) T. Anderson
Hemigraphis reptans	(G. Forst.) T. Anderson ex Hemsl.
Hemionitis palmata	L.
Henriettea fascicularis	(Sw.) G. Maza
Henriettea fascicularis	(Sw.) M. Gómez
Henriettea macfadyenii	(Triana) Alain
Henriettea membranifolia	(Cogn.) Alain
Henriettea squamulosa	(Cogn.) Judd
Henriettea squamulosum	(Cogn.) W.S. Judd
Herissantia crispa	(L.) Briz.
Hernandia sonora	L.
Hesperocyparis arizonica	(Greene) Bartel
Hesperocyparis macrocarpa	(Hartw.) Bartel
Heteranthera limosa	(Sw.) Willd.
Heteranthera reniformis	Ruiz & Pav.
Heteropogon contortus	(L.) P. Beauv. ex Roem. & Schult.
Heteropterys laurifolia	(L.) A. Juss.
Heteropterys laurifolia	(L.) A.Juss.
Heteropterys purpurea	(L.) Kunth
Heteropterys wydleriana	A. Juss.
Heterotis rotundifolia	(Sm.) Jacq.-Fél.
Hibiscus acetosella	Welw. ex Hiern.
Hibiscus bifurcatus	Cav.
Hibiscus cannabinus	L.
Hibiscus clypeatus	L.
Hibiscus elatus	Sw.
Hibiscus furcellatus	Lam.
Hibiscus pernambucensis	Arruda
Hibiscus phoeniceus	Jacq.
Hibiscus rosa-sinensis	L.
Hibiscus sabdariffa	L.
Hibiscus schizopetalus	(Dyer) Hook. f.
Hibiscus trilobus	Aubl.
Hillia parasitica	Jacq.
Hippeastrum puniceum	(Lam.) Kuntze
Hippobroma longiflora	(L.) G. Don
Hippocratea volubilis	L.
Hippomane mancinella	L.
Hirtella rugosa	Thuill. ex Pers.
Hirtella triandra	Sw.
Histiopteris incisa	(Thunb.) J. Sm.
Hohenbergia antillana	Mez
Hohenbergia attenuata	Britton
Hohenbergia portoricensis	Mez
Holcus lanatus	L.
Holmskioldia sanguinea	Retz.
Homalium racemosum	Jacq.
Homalocladium platycladum	(F. Muell.) L.H. Bailey
Homolepis glutinosa	(Sw.) F. Zuloaga & Soderstr.
Homolepis glutinosa	(Sw.) Zuloaga & Soderstr.
Hoya carnosa	(L. f.) R. Br.
Huperzia acerosa	(Sw.) Holub
Huperzia aqualupiana	(Spring) Rothm.
Huperzia dichotoma	(Jacq.) Trevis.
Huperzia funiformis	(Cham. ex Spring) Trevis.
Huperzia linifolia	(L.) Trevis.
Huperzia lucidula	(Michx.) Trevis.
Huperzia reflexa	(Lam.) Trevis.
Huperzia sintenisii	(Herter) Holub
Huperzia taxifolia	(Sw.) Trevis.
Huperzia tenuicaulis	(Underw. & Lloyd) B. Pllg.
Huperzia wilsonii	(Underw. & Lloyd) B. Pllg.
Hura crepitans	L.
Hybanthus linearifolius	(Vahl) Urb.
Hydrocleys nymphoides	(Humb. & Bonpl. ex Willd.) Buchenau
Hydrocotyle bonariensis	Comm. ex Lam.
Hydrocotyle hirsuta	Sw.
Hydrocotyle prolifera	Kellogg
Hydrocotyle pusilla	A. Rich.
Hydrocotyle umbellata	L.
Hyeronima clusioides	(Tul.) Griseb.
Hygrophila costata	Nees
Hylocereus trigonus	(Haw.) Saff.
Hylocereus undatus	(Haw.) Britton & Rose
Hymenachne amplexicaulis	(Rudge) Nees
Hymenaea courbaril	L.
Hymenocallis caribaea	(L.) Herb.
Hymenocallis expansa	(Herb.) Herb.
Hymenocallis latifolia	(Mill.) M. Roem.
Hymenocallis latifolia	(Mill.) M.Roem.
Hymenophyllum asplenioides	(Sw.) Sw.
Hymenophyllum axillare	Sw.
Hymenophyllum brevifrons	Kunze
Hymenophyllum decurrens	(Jacq.) Sw.
Hymenophyllum fragile	(Hedw.) Morton
Hymenophyllum fucoides	(Sw.) Sw.
Hymenophyllum hirsutum	(L.) Sw.
Hymenophyllum lanatum	Fée
Hymenophyllum lineare	(Sw.) Sw.
Hymenophyllum macrothecum	Fée
Hymenophyllum microcarpum	Desv.
Hymenophyllum paucicarpum	Jenman
Hymenophyllum polyanthos	Sw.
Hymenophyllum polyanthos	(Sw.) Sw.
Hymenophyllum sieberi	(C. Presl) Bosch
Hymenophyllum tegularis	(Desv.) Proctor & Lourteig
Hymenophyllum undulatum	(Sw.) Sw.
Hyparrhenia rufa	(Nees) Stapf
Hypelate trifoliata	Sw.
Hyperbaena domingensis	(DC.) Benth.
Hyperbaena laurifolia	(Poir.) Urb.
Hypericum diosmoides	Griseb.
Hypericum hypericoides	(L.) Crantz
Hypoderris brownii	J. Sm.
Hypoestes phyllostachya	Baker
Hypogynium virgatum	(Desv. ex Ham.) Dandy
Hypolepis nigrescens	Hook.
Hypolepis repens	(L.) C. Presl
Hypolepis tenerrima	Maxon
Hypolepis urbanii	Brause
Hypoxis decumbens	L.
Hypoxis wrightii	(Baker) Brackett
Hyptis americana	(Poit.) Briq.
Hyptis atrorubens	Poit.
Hyptis capitata	Jacq.
Hyptis escobilla	Urb.
Hyptis lantanifolia	Poit.
Hyptis pectinata	(L.) Poit.
Hyptis spicigera	Lam.
Hyptis suaveolens	(L.) Poit.
Hyptis verticillata	Jacq.
Ichnanthus nemorosus	(Sw.) Döll
Ichnanthus pallens	(Sw.) Munro ex Benth.
Ichnanthus tenuis	(J. Presl) Hitchc. & Chase
Ilex cassine	L.
Ilex cookii	Britton & P. Wilson
Ilex guianensis	(Aubl.) Kuntze
Ilex hypaneura	Loes.
Ilex krugiana	Loes.
Ilex macfadyenii	(Walp.) Rehder
Ilex nitida	(Vahl) Maxim.
Ilex obcordata	Sw.
Ilex sideroxyloides	(Sw.) Griseb.
Ilex urbaniana	Loes.
Impatiens balsamina	L.
Impatiens walleriana	Hook. f.
Impatiens walleriana	Hook.f.
Imperata brasiliensis	Trin.
Imperata contracta	(Kunth) Hitchc.
Indigofera guatemalensis	Moc. & Sessé ex Prain & Backer
Indigofera hirsuta	L.
Indigofera suffruticosa	Mill.
Indigofera tinctoria	L.
Inga ingoides	(Rich.) Willd.
Inga laurina	(Sw.) Willd.
Inga laurina	(Sw.)Willd.
Inga nobilis	Willd.
Inga vera	Willd.
Ionopsis satyrioides	(Sw.) Rchb. f.
Ionopsis utricularioides	(Sw.) Lindl.
Ipomoea alba	L.
Ipomoea aquatica	Forssk.
Ipomoea batatas	(L.) Lam.
Ipomoea calantha	Griseb.
Ipomoea carnea	Jacq.
Ipomoea hederifolia	L.
Ipomoea horsfalliae	Hook.
Ipomoea imperati	(Vahl) Griseb.
Ipomoea indica	(Burm. f.) Merr.
Ipomoea krugii	Urb.
Ipomoea meyeri	(Spreng.) G. Don
Ipomoea microdactyla	Griseb.
Ipomoea nil	(L.) Roth
Ipomoea ochracea	(Lindl.) G. Don
Ipomoea pes-caprae	(L.) R. Br.
Ipomoea purpurea	(L.) Roth
Ipomoea quamoclit	L.
Ipomoea repanda	Jacq.
Ipomoea setifera	Poir.
Ipomoea steudelii	Millsp.
Ipomoea tenuissima	Choisy
Ipomoea tiliacea	(Willd.) Choisy
Ipomoea tricolor	Cav.
Ipomoea triloba	L.
Ipomoea violacea	L.
Ipomoea wrightii	A. Gray
Iresine angustifolia	Euph.
Iresine argentata	(Mart.) D. Dietr.
Iresine diffusa	Humb. & Bonpl. ex Willd.
Iresine flavescens	Humb. & Bonpl. ex Willd.
Iresine herbstii	Hook.
Iresine lindenii	Van Houtte
Isachne angustifolia	Nash
Isochilus linearis	(Jacq.) R. Br.
Ixora acuminata	Roxb.
Ixora coccinea	L.
Ixora ferrea	(Jacq.) Benth.
Ixora thwaitesii	Hook. f.
Jacaranda mimosifolia	D. Don
Jacquemontia cayensis	Britton
Jacquemontia cumanensis	(Kunth) Kuntze
Jacquemontia havanensis	(Jacq.) Urb.
Jacquemontia ovalifolia	(Vahl ex West) Hallier f.
Jacquemontia pentanthos	(Jacq.) G. Don
Jacquemontia solanifolia	(L.) Hallier
Jacquemontia tamnifolia	(L.) Griseb.
Jacquemontia verticillata	(L.) Urb.
Jacquinia armillaris	Jacq.
Jacquinia berteroi	Spreng.
Jacquinia pauciflora	B. Stähl & F. Axelrod
Jacquinia umbellata	A. DC.
Jacquiniella globosa	(Jacq.) Schltr.
Jacquiniella teretifolia	(Sw.) Britton & P. Wilson
Jaltomata antillana	(Krug & Urb.) D'Arcy
Jasminum fluminense	Vell.
Jasminum multiflorum	(Burm. f.) Andrews
Jasminum officinale	L.
Jasminum sambac	(L.) Aiton
Jatropha curcas	L.
Jatropha gossypiifolia	L.
Jatropha hernandiifolia	Vent.
Jatropha integerrima	Jacq.
Jatropha multifida	L.
Jatropha podagrica	Hook.
Juglans jamaicensis	C. DC.
Juncus dichotomus	Elliott
Juncus effusus	L.
Juncus tenuis	Willd.
Justicia borinquensis	Britton
Justicia comata	(L.) Lam.
Justicia culebritae	Urb.
Justicia martinsoniana	Howard
Justicia mirabiloides	Lam.
Justicia pectoralis	Jacq.
Justicia sphaerosperma	Vahl.
Kaempferia rotunda	L.
Kalanchoe blossfeldiana	Poelln.
Kalanchoe daigremontiana	Raym.-Hamet & H. Perrier
Kalanchoe delagoensis	Eckl. & Zeyh.
Kalanchoe fedtschenkoi	Raym.-Hamet & H. Perrier
Kalanchoe integra	(Medik.) Kuntze
Kalanchoe pinnata	(Lam.) Pers.
Kallstroemia maxima	(L.) Hook. & Arn.
Kallstroemia pubescens	(G. Don) Dandy
Khaya anthotheca	(Welw.) C. DC.
Khaya senegalensis	(Desr.) A. Juss.
Kigelia africana	(Lam.) Benth.
Kleinhovia hospita	L.
Koanophyllon dolicholepis	(Urb.) R.M. King & H. Rob.
Koanophyllon droserolepis	(B.L. Rob.) R.M. King & H. Rob.
Koanophyllon polyodon	(Urb.) R.M. King & H. Rob.
Koellensteinia graminea	(Lindl.) Rchb. f.
Krameria ixine	L.
Krugiodendron ferreum	(Vahl) Urb.
Kyllinga brevifolia	Rottb.
Kyllinga nemoralis	(J.R. Forst. & G. Forst.) Dandy ex Hutch. & Dalziel
Kyllinga odorata	Vahl
Kyllinga pumila	Michx.
Kyllinga tibialis	Ledeb.
Kyllinga vaginata	Lam.
Lablab purpureus	(L.) Sweet
Lactuca floridana	(L.) Gaertn.
Lactuca sativa	L.
Laetia procera	(Poepp.) Eichl.
Laetia procera	(Poepp.) Eichler
Lagascea mollis	Cav.
Lagenaria siceraria	(Molina) Standl.
Lagenocarpus guianensis	Lindl. & Nees
Lagerstroemia indica	L.
Lagerstroemia speciosa	(L.) Pers.
Laguncularia racemosa	(L.) C.F. Gaertn.
Landoltia punctata	(G. Mey.) D.H. Les & D.J. Crawford
Lantana camara	L.
Lantana exarata	Urb. & Ekman
Lantana involucrata	L.
Lantana montevidensis	(Spreng.) Briq.
Lantana reticulata	Pers.
Lantana scabrida	Aiton
Lantana strigosa	(Griseb.) Urb.
Lantana trifolia	L.
Lantana urticifolia	Mill.
Laplacea portoricensis	Dyer
Laplacea portoricensis	(Krug & Urb.) Dyer
Laportea aestuans	(L.) Chew
Lasiacis divaricata	(L.) Hitchc.
Lasiacis grisebachii	(Nash) Hitchc.
Lasiacis ligulata	Hitchc. & Chase
Lasiacis sloanei	(Griseb.) Hitchc.
Lasiacis sorghoidea	(Desv. ex Ham.) Hitchc. & Chase
Lasianthus lanceolatus	(Griseb.) G. Maza
Lasianthus lanceolatus	(Griseb.) Urb.
Lastreopsis effusa	(Sw.) Tindale
Launaea intybacea	(Jacq.) P. Beauv.
Lawsonia inermis	L.
Leandra krugiana	(Cogn.) W.S. Judd & Skean
Leandra krugii	(Cogn.) W.S. Judd & Skean
Leersia hexandra	Sw.
Leersia monandra	Sw.
Lellingeria hartii	(Jenman) A.R. Sm. & R.C. Moran
Lellingeria myosuroides	(Sw.) A.R. Sm. & R.C. Moran
Lellingeria suspensa	(L.) A.R. Sm. & R.C. Moran
Lemna aequinoctialis	Welw.
Lemna minuta	Kunth
Lemna perpusilla	Torr.
Lemna valdiviana	Phil.
Leochilus puertoricensis	M.W.Chase
Leochilus puertoricensis	M.W. Chase
Leonotis nepetifolia	(L.) R. Br.
Leonurus sibiricus	L.
Lepanthes caritensis	Tremblay & Ackerman
Lepanthes dodiana	Stimson
Lepanthes eltoroensis	Stimson
Lepanthes rubripetala	Stimson
Lepanthes rupestris	Stimson
Lepanthes sanguinea	Hook.
Lepanthes selenitepala	Rchb. f.
Lepanthes selenitepala	Rchb.f.
Lepanthes veleziana	Stimson
Lepanthes woodburyana	Stimson
Lepanthopsis melanantha	(Rchb. f.) Ames
Lepianthes peltata	(L.) Raf.
Lepidagathis alopecuroidea	(Vahl) R.Br. ex Griseb.
Lepidium pinnatisectum	(O.E. Schulz) C.L. Hitchc.
Lepidium virginicum	L.
Leptocereus grantianus	Britton
Leptocereus quadricostatus	(Bello) Britton & Rose
Leptochloa fusca	(L.) Kunth
Leptochloa nealleyi	Vasey
Leptochloa panicea	(Retz.) Ohwi
Leptochloa panicoides	(J. Presl) Hitchc.
Leptochloa scabra	Nees
Leptochloa virgata	(L.) P. Beauv.
Leptochloopsis virgata	(Poir.) Yates
Leptocoryphium lanatum	(Kunth) Nees
Leucaena leucocephala	(Lam.) de Wit
Leucanthemum maximum	(Ramond) DC.
Leucothrinax morrisii	(H. Wendl.) C.Lewis & Zona
Licania rigida	Benth.
Licaria brittoniana	Allen & Gregory
Licaria parvifolia	(Lam.) Kosterm.
Licaria triandra	(Sw.) Kosterm.
Ligustrum japonicum	Thunb.
Ligustrum ovalifolium	Hassk.
Ligustrum sinense	Lour.
Limnobium laevigatum	(Humb. & Bonpl. ex Willd.) Heine
Lindernia crustacea	(L.) F. Muell.
Lindernia crustacea	(L.) F.Muell.
Lindernia diffusa	(L.) Wettst.
Lindernia dubia	(L.) Pennell
Lindsaea lancea	(L.) Bedd.
Lindsaea portoricensis	Desv.
Lindsaea quadrangularis	Raddi
Lindsaea stricta	(Sw.) Dryand. ex Sm.
Liparis elata	Lindl.
Liparis nervosa	(Thunb.) Lindl.
Liparis saundersiana	Rchb. f.
Liparis vexillifera	(Llave & Lex.) Cogn.
Lipocarpha micrantha	(Vahl) G. Tucker
Lippia alba	(Mill.) N.E. Br. ex Britton & P. Wilson
Lippia micromera	Schauer
Lisianthius laxiflorus	Urb.
Lithachne pauciflora	(Sw.) P. Beauv.
Lithophila muscoides	Sw.
Lobelia cliffortiana	L.
Lobelia portoricensis	(Vatke) Urb.
Lobelia robusta	Graham
Lobelia rotundifolia	Juss. ex A. DC.
Lobelia vivaldii	Lammers & Proctor
Lolium perenne	L.
Lomagramma guianensis	(Aubl.) Ching
Lomariopsis amydrophlebia	(Sloss. ex Maxon) Holttum
Lomariopsis amydrophlebia	(Slosson ex Maxon) Holttum
Lomariopsis kunzeana	(C. Presl ex Underw.) Holttum
Lomariopsis kunzeana	(Underw.) Holttum
Lomariopsis sorbifolia	(L.) Fée
Lonchitis hirsuta	L.
Lonchocarpus domingensis	(Turp. ex Pers.) DC.
Lonchocarpus glaucifolius	Urb.
Lonchocarpus heptaphyllus	(Poir.) DC.
Lonchocarpus heptaphyllus	(Poir.)DC.
Lonicera japonica	Thunb.
Lophosoria quadripinnata	(J.F. Gmel.) C. Chr.
Lophospermum erubescens	D. Don
Lucya tetrandra	(L.) K. Schum.
Ludwigia decurrens	Walter
Ludwigia erecta	(L.) H. Hara
Ludwigia leptocarpa	(Nutt.) H. Hara
Ludwigia octovalvis	(Jacq.) P.H.Raven
Ludwigia octovalvis	(Jacq.) P.H. Raven
Ludwigia palustris	(L.) Elliott
Ludwigia peploides	(Kunth) P.H. Raven
Ludwigia peruviana	(L.) H. Hara
Luehea speciosa	Willd.
Luffa acutangula	(L.) Roxb.
Luffa aegyptiaca	Mill.
Lunania ekmanii	Urb.
Lycaste barringtoniae	(Sm.) Lindl.
Lycianthes virgata	(Lam.) Bitter
Lycium tweedianum	Griseb.
Lycopodiella caroliniana	(L.) Pic. Serm.
Lycopodiella cernua	(L.) Pic. Serm.
Lycopodium clavatum	L.
Lygodium japonicum	(Thunb.) Sw.
Lyonia rubiginosa	(Pers.) G. Don
Lyonia truncata	Urb.
Macadamia integrifolia	Maiden & Betche
Macfadyena unguis-cati	(L.) A.H. Gentry
Machaerina restioides	(Sw.) Vahl
Machaerium lunatum	(L. f.) Ducke
Machaonia portoricensis	Baill.
Maclura tinctoria	(L.) D. Don ex Steud.
Macroptilium atropurpureum	(Moc. & Sessé ex DC.) Urb.
Macroptilium lathyroides	(L.) Urb.
Macrothelypteris torresiana	(Gaudich.) Ching
Maesopsis eminii	Engl.
Magnolia grandiflora	L.
Magnolia portoricensis	Bello
Magnolia splendens	Urb.
Malachra alceifolia	Jacq.
Malachra capitata	(L.) L.
Malachra fasciata	Jacq.
Malachra radiata	L.
Malaxis major	(Rchb. f.) Léon ex A.D. Hawkes
Malaxis massonii	(Ridley) Kuntze
Malaxis massonii	(Ridl.) Kuntze
Malaxis spicata	Sw.
Malpighia coccigera	L.
Malpighia emarginata	Sessé & Moc. ex DC.
Malpighia fucata	Ker Gawl.
Malpighia infestissima	Rich. ex Nied.
Malpighia linearis	Jacq.
Malpighia setosa	Spreng.
Malpighia woodburyana	Vivaldi
Malvastrum americanum	(L.) Torr.
Malvastrum corchorifolium	(Desv.) Britton ex Small
Malvastrum coromandelianum	(L.) Garcke
Malvaviscus arboreus	Dill. ex Cav.
Malvaviscus penduliflorus	DC.
Malvaviscus penduliflorus	Moc. & Sessé ex DC.
Mammea americana	L.
Mammillaria nivosa	Link ex N.E. Pfeiffer
Mangifera indica	L.
Manihot esculenta	Crantz
Manilkara bidentata	(A. DC.) A. Chev
Manilkara bidentata	(A.DC.) A.Chev.
Manilkara pleeana	(Pierre ex Baill.) Cronquist
Manilkara valenzuela	(A. Rich.) T.D. Penn.
Manilkara zapota	(L.) P. Royen
Mansoa alliacea	(Lam.) A.H. Gentry
Mappia racemosa	Jacq.
Maranta arundinacea	L.
Marcgravia rectiflora	Triana & Planch.
Marcgravia sintenisii	Urb.
Margaritaria nobilis	L. f.
Margaritaria nobilis	L.f.
Marlierea sintenisii	Kiaersk.
Marsdenia elliptica	Decne.
Marsdenia woodburyana	Acev.-Rodr.
Marsilea ancylopoda	A. Braun
Marsilea polycarpa	Hook. & Grev.
Marsypianthes chamaedrys	(Vahl) Kuntze
Martynia annua	L.
Matayba domingensis	(DC.) Radlk.
Matelea borinquensis	Alain
Matelea maritima	(Jacq.) Woodson
Matelea sintenisii	(Schltr.) Woodson
Matelea variifolia	(Schltr.) Woodson
Maxillaria acutifolia	Lindl.
Maxillaria coccinea	(Jacq.) L.O. Williams ex Hodge
Maxillaria parviflora	(Poepp. & Endl.) Garay
Maytenus cymosa	Krug & Urb.
Maytenus elongata	Britton
Maytenus elongata	(Urb.) Britton
Maytenus laevigata	(Vahl) Griseb. ex Eggers
Maytenus ponceana	Britton
Mecardonia procumbens	(Mill.) Small
Mecranium latifolium	(Cogn.) Skean
Medicago sativa	L.
Megalastrum martinicense	R.C.Moran, J.Prado & Labiak
Megalastrum subincisa	(Willd.) A.R. Sm. & R.C. Moran
Megathyrsus maximus	(Jacq.) B.K.Simon & Jacobs
Melaleuca quinquenervia	(Cav.) S.F. Blake
Melampodium divaricatum	(Rich.) DC.
Melanthera aspera	(Jacq.) Steud. ex Small
Melanthera nivea	(L.) Small
Melia azedarach	L.
Melicoccus bijugatus	Jacq.
Melilotus officinalis	(L.) Lam.
Melinis minutiflora	P. Beauv.
Melinis minutiflora	P.Beauv.
Melinis repens	(Willd.) Zizka
Meliosma herbertii	Rolfe
Meliosma obtusifolia	(Bello) Krug & Urb.
Melocactus intortus	(Mill.) Urb.
Melochia nodiflora	Sw.
Melochia pyramidata	L.
Melochia spicata	(L.) Fryxell
Melochia tomentosa	L.
Melothria pendula	L.
Melpomense anfractuosa	(Kunze ex Klotzsch) A.R. Sm. & R.C. Moran
Melpomense flabelliformis	(Poir.) A.R. Sm. & C.R. Moran
Mentha aquatica	L.
Mentha ×piperita	L. (pro sp.)
Mentha ×villosa	Huds. (pro sp.)
Mentzelia aspera	L.
Merremia aegyptia	(L.) Urb.
Merremia cissoides	(Lam.) Hallier f.
Merremia dissecta	(Jacq.) Hallier f.
Merremia quinquefolia	(L.) Hallier f.
Merremia tuberosa	(L.) Rendle
Merremia umbellata	(L.) Hallier f.
Mesadenus lucayanus	(Britton) Schltr.
Metopium toxiferum	(L.) Krug & Urb.
Mickelia nicotianifolia	(Sw.) R.C. Moran, Labiak & Sundue
Miconia affinis	DC.
Miconia foveolata	Cogn.
Miconia impetiolaris	(Sw.) D. Don ex DC.
Miconia laevigata	(L.) D. Don
Miconia lanata	(DC.) Triana, nom. inq.
Miconia mirabilis	(Aubl.) L.O. Williams
Miconia pachyphylla	Cogn.
Miconia prasina	(Sw.) DC.
Miconia punctata	(Desr.) D. Don ex DC.
Miconia pycnoneura	Urb.
Miconia racemosa	(Aubl.) DC.
Miconia rubiginosa	(Bonpl.) DC.
Miconia serrulata	(DC.) Naud.
Miconia serrulata	(DC.) Naudin
Miconia sintenisii	Cogn.
Miconia splendens	(Sw.) Griseb.
Miconia subcorymbosa	Britton
Miconia tetrandra	(Sw.) D. Don
Miconia tetrandra	(Sw.) D. Don ex G. Don
Miconia tetrastoma	Naud.
Miconia theaezans	(Bonpl.) Cogn.
Miconia thomasiana	DC.
Micranthemum umbrosum	(J.F. Gmel.) S.F. Blake
Microchilus familiaris	Ormerod
Microchilus hirtellus	(Sw.) D.Dietr.
Microchilus plantagineus	(L.) D.Dietr.
Microgramma heterophylla	(L.) Wherry
Microgramma lycopodioides	(L.) Copel.
Microgramma lycopodioides	(L.) Copeland
Microgramma piloselloides	(L.) Copel.
Microgramma piloselloides	(L.) Copeland
Micropholis garciniifolia	Pierre
Micropholis guyanensis	(A. DC.) Pierre
Micropholis guyanensis	(A.DC.) Pierre
Microstachys corniculata	(Vahl) Griseb.
Microstegium vimineum	(Trin.) A. Camus
Microtea debilis	Sw.
Microtea portoricensis	Urb.
Mikania congesta	DC.
Mikania cordifolia	(L. f.) Willd.
Mikania cordifolia	(L.f.) Willd.
Mikania fragilis	Urb.
Mikania micrantha	Kunth
Mikania odoratissima	Urb.
Mikania pachyphylla	Urb.
Mikania porosa	Urb.
Mikania stevensiana	Britton
Millettia pinnata	(L.) Panigrahi
Mimosa arenosa	(Willd.) Poir.
Mimosa casta	L.
Mimosa ceratonia	L.
Mimosa diplotricha	C. Wright
Mimosa pellita	Kunth ex Willd.
Mimosa pudica	L.
Mimosa quadrivalvis	L.
Mirabilis jalapa	L.
Mitracarpus hirtus	(L.) DC.
Mitracarpus maxwelliae	Britton & P. Wilson
Mitracarpus polycladus	Urb.
Mitracarpus portoricensis	(Urb.) Urb.
Mitreola petiolata	(J.F. Gmel.) Torr. & A. Gray
Molineria capitulata	(Lour.) Herb.
Mollugo nudicaulis	Lam.
Mollugo verticillata	L.
Momordica balsamina	L.
Momordica charantia	L.
Monstera adansonii	Schott
Monstera deliciosa	Liebm.
Moranopteris taenifolia	(Jenman) R.Y. Hirai & J. Prado
Morella cerifera	(L.) Small
Morella holdridgeana	(Lundell) Kartesz
Morinda citrifolia	L.
Moringa oleifera	Lam.
Morisonia americana	L.
Mormolyca pudica	(Carnevali & J.L.Tapia) M.A.Blanco
Morus nigra	L.
Mouriri domingensis	(Tussac) Spach
Mouriri helleri	Britton
Mucuna pruriens	(L.) DC.
Mucuna sloanei	Fawc. & Rendle
Mucuna urens	(L.) Medik.
Muhlenbergia capillaris	(Lam.) Trin.
Muntingia calabura	L.
Murdannia nudiflora	(L.) Brenan
Murraya exotica	L.
Musa ×paradisiaca	L. (pro sp.)
Musa velutina	H. Wendl. & Drude
Musa x paradisiaca	L.
Myrcia amazonica	DC.
Myrcia citrifolia	(Aubl.) Urb.
Myrcia deflexa	(Poir.) DC.
Myrcia fallax	(Rich.) DC.
Myrcia leptoclada	DC.
Myrcia margarettiae	(Alain) Alain
Myrcia maricaensis	Alain
Myrcianthes fragrans	(Sw.) McVaugh
Myrcia paganii	Krug & Urb.
Myrciaria borinquena	Alain
Myrciaria floribunda	(West ex Willd.) Berg
Myrciaria myrtifolia	Alain
Myrcia splendens	(Sw.) DC.
Myristica fragrans	Houtt.
Myrosma cannifolia	L. f.
Myrospermum frutescens	Jacq.
Myrsine coriacea	(Sw.) R. Br. ex Roem. & Schult.
Myrsine coriacea	(Sw.) R.Br. ex Roem. & Schult.
Myrsine cubana	A. DC.
Najas guadalupensis	(Spreng.) Magnus
Najas marina	L.
Nama jamaicense	L.
Nashia inaguensis	Millsp.
Nasturtium officinale	W.T. Aiton
Nectandra coriacea	(Sw.) Griseb.
Nectandra hihua	(Ruiz & Pav.) Rohwer
Nectandra krugii	Mez
Nectandra membranacea	(Sw.) Griseb.
Nectandra patens	(Sw.) Griseb.
Nectandra turbacensis	(Kunth) Nees
Neea buxifolia	(Hook. f.) Heimerl
Nekemias arborea	(L.) J. Wen & Boggan
Nelsonia canescens	(Lam.) Spreng.
Neolamarckia cadamba	(Roxb.) F. Bosser
Neolaugeria resinosa	(Vahl) Nicolson
Neomarica northiana	(Schneev.) Sprague
Neorudolphia volubilis	(Willd.)Britton
Neorudolphia volubilis	(Willd.) Britton
Nephrolepis biserrata	(Sw.) Schott
Nephrolepis brownii	(Desv.) Hovenkamp & Miyam.
Nephrolepis cordifolia	(L.) C. Presl
Nephrolepis exaltata	(L.) Schott
Nephrolepis falcata	(Cav.) C. Chr.
Nephrolepis laurifolia	(Christ) Proctor
Nephrolepis multiflora	(Roxb.) Jarrett ex Morton
Nephrolepis rivularis	(Vahl) Mett. ex Krug
Nephrolepis undulata	(Afzelius ex Sw.) J. Sm.
Nepsera aquatica	(Aubl.) Naud.
Nepsera aquatica	(Aubl.) Naudin
Neptunia plena	(L.) Benth.
Neptunia prostrata	(Lam.) Baill.
Nerium oleander	L.
Neurodium lanceolatum	(L.) Fée
Neurolaena lobata	(L.) Cass.
Neurolaena lobata	(L.) R.Br. ex Cass.
Nicotiana tabacum	L.
Nidema ottonis	(Rchb. f.) Britton & Millsp.
Niphidium crassifolium	(L.) Lellinger
Notholaena trichomanoides	(L.) Desv.
Notopleura guadalupensis	(DC.) C.M.Taylor
Notopleura uliginosa	(Sw.) Bremek.
Nymphaea amazonum	Mart. & Zucc.
Nymphaea ampla	(Salisb.) DC.
Nymphaea conardii	Wiersema
Nymphaea jamesoniana	Planch.
Nymphaea odorata	Aiton
Nymphaea rudgeana	G. Mey.
Nymphoides indica	(L.) Kuntze
Ochna jabotapita	L.
Ochna mossambicensis	Klotzsch
Ochroma pyramidale	(Cav. ex Lam.) Urb.
Ocimum basilicum	L.
Ocimum campechianum	Mill.
Ocimum tenuiflorum	L.
Ocotea floribunda	(Sw.) Mez
Ocotea foeniculacea	Mez
Ocotea leucoxylon	(Sw.) De Laness.
Ocotea leucoxylon	(Sw.) Laness.
Ocotea moschata	(Meisn.) Mez
Ocotea moschata	(Pav. ex Meisn.) Mez
Ocotea nemodaphne	Mez
Ocotea portoricensis	Mez
Ocotea spathulata	Mez
Ocotea wrightii	(Meisn.) Mez
Odontonema cuspidatum	(Nees) Kuntze
Odontonema tubiforme	(Bertol.) Kuntze
Odontosoria aculeata	(L.) J. Sm.
Odontosoria clavata	L.
Odontosoria scandens	(Desv.) C. Chr.
Oeceoclades maculata	(Lindl.) Lindl.
Oldenlandia corymbosa	L.
Oldenlandia lancifolia	(Schumach.) DC.
Oldenlandia uniflora	L.
Oldenlandiopsis callitrichoides	(Griseb.) Terrell & W.H. Lewis
Oleandra articulata	(Sw.) C. Presl
Olfersia cervina	(L.) Kunze
Olyra latifolia	L.
Oncidium altissimum	(Jacq.) Sw.
Oncidium meirax	Rchb. f.
Operculina turpethum	(L.) Silva Manso
Ophioglossum reticulatum	L.
Oplismenus hirtellus	(L.) P. Beauv.
Oplismenus hirtellus	(L.) P.Beauv.
Oplonia microphylla	(Lam.) Stearn
Oplonia spinosa	(Jacq.) Raf.
Opuntia borinquensis	Britton & Rose
Opuntia cochenillifera	(L.) Mill.
Opuntia ×cubensis	Britton & Rose
Opuntia dillenii	(Ker Gawl.) Haw.
Opuntia ficus-indica	(L.) Mill.
Opuntia repens	Bello
Opuntia triacantha	(Willd.) Sweet
Ormosia krugii	Urb.
Ornithidium coccineum	(Jacq.) Salisb. ex R.Br.
Oryza latifolia	Desv.
Oryza sativa	L.
Osmunda cinnamomea	L.
Ottoschulzia rhodoxylon	(Urb.) Urb.
Ouratea ilicifolia	(DC.) Baill.
Ouratea littoralis	Urb.
Ouratea striata	(v. Tiegh.) Urb.
Oxalis barrelieri	L.
Oxalis corniculata	L.
Oxalis debilis	Kunth
Oxalis eggersii	Urb.
Oxalis intermedia	A. Rich.
Oxalis latifolia	Kunth
Oxalis rugeliana	Urb.
Oxalis violacea	L.
Oxandra lanceolata	(Sw.) Baill.
Oxandra laurifolia	(Sw.) A. Rich.
Oxypetalum cordifolium	(Vent.) Schltr.
Pachira aquatica	Aubl.
Pachira insignis	(Sw.) Sw. ex Savigny
Pachyrhizus erosus	(L.) Urb.
Pachyrhizus tuberosus	(Lam.) Spreng.
Pachystachys spicata	(Ruiz & Pav.) Wassh.
Palicourea alpina	(Sw.) DC.
Palicourea crocea	(Sw.) Schult.
Palicourea croceoides	Ham.
Palicourea guianensis	Aubl.
Pandanus baptistii	hort. ex Misonne
Pandanus tectorius	Parkinson ex Zucc.
Pandanus utilis	Bory
Pandanus veitchii	hort. Veitch ex Masters & T. Moore
Panicum dichotomiflorum	Michx.
Panicum diffusum	Sw.
Panicum elephantipes	Nees
Panicum ghiesbreghtii	Fourn.
Panicum hylaeicum	Mez
Panicum laxum	Sw.
Panicum miliaceum	L.
Panicum parvifolium	Lam.
Panicum rigidulum	Bosc ex Nees
Panicum schiffneri	Hack.
Panicum stenodes	Griseb.
Panicum stevensianum	Hitchc. & Chase
Panicum tenerum	Bey. ex Trin.
Panicum trichanthum	Nees
Panicum trichoides	Sw.
Panicum venezuelae	Hack.
Pappophorum pappiferum	(Lam.) Kuntze
Parathesis crenulata	(Vent.) Hook. f.
Parathesis crenulata	(Vent.) Hook. f. ex Hemsl.
Parkinsonia aculeata	L.
Parmentiera aculeata	(Kunth) Seem.
Parmentiera cereifera	Seem.
Parthenium hysterophorus	L.
Paspalidium chapmanii	(Vasey) Pohl
Paspalidium geminatum	(Forssk.) Stapf
Paspalum arundinaceum	Poir.
Paspalum bakeri	Hook.
Paspalum blodgettii	Chapm.
Paspalum boscianum	Flueggé
Paspalum caespitosum	Flueggé
Paspalum clavuliferum	C. Wright
Paspalum conjugatum	P.J.Bergius
Paspalum conjugatum	P.J. Bergius
Paspalum convexum	Humb. & Bonpl. ex Flueggé
Paspalum decumbens	Sw.
Paspalum densum	Poir.
Paspalum dilatatum	Poir.
Paspalum dispar	Chase
Paspalum distichum	L.
Paspalum fasciculatum	Willd. ex Flueggé
Paspalum fimbriatum	Kunth
Paspalum laxum	Lam.
Paspalum macrophyllum	Kunth
Paspalum maritimum	Trin.
Paspalum millegrana	Schrad.
Paspalum minus	Fourn.
Paspalum molle	Poir.
Paspalum notatum	Flueggé
Paspalum orbiculatum	Poir.
Paspalum paniculatum	L.
Paspalum parviflorum	Rohde ex Flueggé
Paspalum paucispicatum	Vasey
Paspalum pleostachyum	Döll
Paspalum plicatulum	Michx.
Paspalum pulchellum	Kunth
Paspalum rupestre	Trin.
Paspalum secans	Hitchc. & Chase
Paspalum setaceum	Michx.
Paspalum urvillei	Steud.
Paspalum vaginatum	Sw.
Paspalum virgatum	L.
Passiflora anadenia	Urb.
Passiflora berteriana	Balbis ex DC.
Passiflora bilobata	Juss.
Passiflora ciliata	Aiton
Passiflora edulis	Sims
Passiflora foetida	L.
Passiflora laurifolia	L.
Passiflora maliformis	L.
Passiflora multiflora	L.
Passiflora murucuja	L.
Passiflora pallida	L.
Passiflora quadrangularis	L.
Passiflora rubra	L.
Passiflora serratodigitata	L.
Passiflora sexflora	Juss.
Passiflora suberosa	L.
Passiflora tuberosa	Jacq.
Passiflora tulae	Urb.
Paullinia pinnata	L.
Pavonia corymbosa	(Sw.) Willd.
Pavonia fruticosa	(Mill.) Fawc. & Rendle
Pavonia paludicola	Nicolson ex Fryxell
Pavonia paniculata	Cav.
Pavonia spinifex	(L.) Cav.
Pecluma camptophyllaria	(Fée) M.G. Price
Pecluma consimilis	(Mett.) M.G. Price
Pecluma dispersa	(A.M. Evans) M.G. Price
Pecluma pectinata	(L.) M.G. Price
Pecluma plumula	(Humb. & Bonpl. ex Willd.) M.G. Price
Pecluma ptilodon	(Kunze) M.G. Price
Pectis carthusianorum	Less.
Pectis ciliaris	L.
Pectis elongata	Kunth
Pectis humifusa	Sw.
Pectis linearis	Llave
Pectis linifolia	L.
Pectis prostrata	Cav.
Pectis tenuicaulis	Urb.
Pedilanthus tithymaloides	(L.) Poit.
Pelargonium graveolens	L'Hér. ex Aiton
Pelargonium odoratissimum	(L.) L'Hér. ex Aiton
Pelargonium peltatum	(L.) L'Hér. ex Aiton
Pelargonium zonale	(L.) L'Hér. ex Aiton
Pelexia adnata	(Sw.) Poit. ex Rich.
Pelexia adnata	(Sw.) Spreng.
Peltophorum pterocarpum	(DC.) Backer ex K. Heyne
Pennisetum ciliare	(L.) Link
Pennisetum clandestinum	Hochst. ex Chiov.
Pennisetum glaucum	(L.) R. Br.
Pennisetum polystachion	(L.) Schult.
Pennisetum purpureum	Schumach.
Pentalinon luteum	(L.) B.F. Hansen & Wunderlin
Pentapetes phoenicea	L.
Pentas lanceolata	(Forssk.) Deflers
Peperomia alata	Ruiz & Pav.
Peperomia cogniauxii	Urb.
Peperomia distachya	(L.) A. Dietr.
Peperomia distachya	(L.) A.Dietr.
Peperomia emarginella	(Sw. ex Wikstr.) C. DC.
Peperomia emarginella	(Sw. ex Wikstr.) C.DC.
Peperomia glabella	(Sw.) A. Dietr.
Peperomia hernandiifolia	(Vahl) A. Dietr.
Peperomia humilis	A. Dietr.
Peperomia maculosa	(L.) Hook.
Peperomia magnoliifolia	(Jacq.) A. Dietr.
Peperomia maxonii	C. DC.
Peperomia megalopoda	Trel.
Peperomia myrtifolia	(Vahl) A. Dietr.
Peperomia obtusifolia	(L.) A. Dietr.
Peperomia parvulifolia	Trel.
Peperomia pellucida	(L.) Kunth
Peperomia portoricensis	Urb.
Peperomia quadrifolia	(L.) Kunth
Peperomia rhombea	Ruiz & Pav.
Peperomia robustior	Urb.
Peperomia rotundifolia	(L.) Kunth
Peperomia serpens	(Sw.) Loudon
Peperomia sintenisii	C. DC.
Peperomia tenella	(Sw.) A. Dietr.
Peperomia tetraphylla	(G. Forst.) Hook. & Arn.
Peperomia urocarpa	Fisch. & C.A. Mey.
Peperomia wheeleri	Britton
Peperomia yabucoana	Urb. & C. DC.
Pera bumeliifolia	Griseb.
Pereskia aculeata	Mill.
Pereskia grandifolia	Haw.
Persea americana	Mill.
Persea krugii	Mez
Persea urbaniana	Mez
Petitia domingensis	Jacq.
Petiveria alliacea	L.
Petrea volubilis	L.
Petroselinum crispum	(Mill.) Nyman ex A.W. Hill
Petunia integrifolia	(Hook.) Schinz & Thell.
Pfaffia grandiflora	(Hook.) R.E. Fries
Phaius tancarvilleae	(Banks ex L'Hér.) Blume
Pharus lappulaceus	Aubl.
Pharus latifolius	L.
Pharus parvifolius	Nash
Phaseolus lunatus	L.
Phaseolus polystachios	(L.) Britton, Sterns & Poggenb.
Phaseolus vulgaris	L.
Phenax sonneratii	(Poir.) Weddell
Phialanthus grandifolius	Alain
Phialanthus myrtilloides	Griseb.
Philodendron bipinnatifidum	Schott ex Endl.
Philodendron consanguineum	Schott
Philodendron fragrantissimum	(Hook.) G. Don
Philodendron giganteum	Schott
Philodendron hederaceum	(Jacq.) Schott
Philodendron lingulatum	(L.) K.Koch
Philodendron lingulatum	(L.) K. Koch
Philodendron marginatum	Urb.
Philodendron ornatum	Schott
Phlebodium aureum	(L.) J. Sm.
Phlebodium decumanum	(Willd.) J. Sm.
Phlebodium pseudoaureum	(Cav.) Lellinger
Phoradendron anceps	(Spreng.) G. Maza
Phoradendron anceps	(Spreng.) M.Gómez
Phoradendron barahonae	Urb. & Trel.
Phoradendron dichotomum	(Bertero ex Spreng.) Krug & Urb.
Phoradendron hexastichum	(DC.) Griseb.
Phoradendron piperoides	(Kunth) Trel.
Phoradendron quadrangulare	(Kunth) Griseb.
Phoradendron racemosum	(Aubl.) Krug & Urb.
Phoradendron tetrapterum	Krug & Urb.
Phoradendron trinervium	(Lam.) Griseb.
Phragmites australis	(Cav.) Trin. ex Steud.
Phyla dulcus	(Trevir.) Moldenke
Phyla fruticosa	(Mill.) Kennedy
Phyla nodiflora	(L.) Greene
Phyla stoechadifolia	(L.) Small
Phyllanthus acidus	(L.) Skeels
Phyllanthus acuminatus	Vahl
Phyllanthus amarus	Schumach. & Thonn.
Phyllanthus debilis	Klein ex Willd.
Phyllanthus emblica	L.
Phyllanthus epiphyllanthus	L.
Phyllanthus fraternus	G.L. Webster
Phyllanthus juglandifolius	Willd.
Phyllanthus niruri	L.
Phyllanthus orbicularis	Kunth
Phyllanthus pentaphyllus	C. Wright ex Griseb.
Phyllanthus stipulatus	(Raf.) G.L. Webster
Phyllanthus tenellus	Roxb.
Phyllanthus urinaria	L.
Phymatosorus scolopendria	(Burm. f.) Pic. Serm.
Physalis angulata	L.
Physalis cordata	Mill.
Physalis pubescens	L.
Physalis turbinata	Medik.
Phytolacca icosandra	L.
Phytolacca rivinoides	Kunth & Bouché
Phytolacca rivinoides	Kunth & C.D.Bouché
Picramnia pentandra	Sw.
Picrasma excelsa	(Sw.) Planch.
Pictetia aculeata	(Vahl) Urb.
Pilea depressa	(Sw.) Blume
Pilea herniarioides	(Sw.) Lindl.
Pilea inaequalis	(Juss. ex Poir.) Wedd.
Pilea inaequalis	(Juss. ex Poir.) Weddell
Pilea krugii	Urb.
Pilea leptophylla	Urb.
Pilea margarettiae	Britton
Pilea microphylla	(L.) Liebm.
Pilea multicaulis	Urb.
Pilea nummulariifolia	(Sw.) Wedd.
Pilea nummulariifolia	(Sw.) Weddell
Pilea obtusata	Liebm.
Pilea parietaria	(L.) Blume
Pilea richardii	Urb.
Pilea rivoriae	Weddell
Pilea sanctae-crucis	Liebm.
Pilea semidentata	(Juss. ex Poir.) Weddell
Pilea semidentata	Wedd.
Pilea tenerrima	Miq.
Pilea yunquensis	(Urb.) Britton & P. Wilson
Pilocarpus racemosus	Vahl
Pilosocereus royenii	(L.) Byles & Rowley
Pimenta dioica	(L.) Merr.
Pimenta racemosa	(Mill.) J.W.Moore
Pimenta racemosa	(Mill.) J.W. Moore
Pinochia corymbosa	(Jacq.) M.E.Endress & B.F.Hansen
Pinus caribaea	Morelet
Pinzona coriacea	Mart. & Zucc.
Piper aduncum	L.
Piper amalago	L.
Piper blattarum	Spreng.
Piper dilatatum	Rich.
Piper glabrescens	(Miq.) C. DC.
Piper glabrescens	(Miq.) C.DC.
Piper hispidum	Sw.
Piper jacquemontianum	Kunth
Piper marginatum	Jacq.
Piper swartzianum	(Miq.) C. DC.
Piper umbellatum	L.
Piptocarpha tetrantha	Urb.
Piptocoma acevedoi	Pruski
Piptocoma antillana	Urb.
Piriqueta cistoides	(L.) Griseb.
Piriqueta racemosa	(Jacq.) Sweet
Piriqueta viscosa	Griseb.
Piscidia carthagenensis	Jacq.
Pisonia aculeata	L.
Pisonia albida	(Heimerl) Britton ex Standl.
Pisonia subcordata	Sw.
Pisonia taina	Trejo
Pistia stratiotes	L.
Pitcairnia angustifolia	Aiton
Pithecellobium dulce	(Roxb.) Benth.
Pithecellobium unguis-cati	(L.) Benth.
Pityrogramma austroamericana	Domin
Pityrogramma calomelanos	(L.) Link
Pityrogramma chrysophylla	(Sw.) Link
Pityrogramma ebenea	(L.) Proctor
Pityrogramma sulphurea	(Sw.) Maxon
Pityrogramma trifoliata	(L.) R. Tryon
Plantago lanceolata	L.
Plantago major	L.
Platycladus orientalis	(L.) Franco
Plectranthus amboinicus	(Lour.) Spreng.
Plectranthus scutellarioides	(L.) R.Br.
Plectranthus verticillatus	(L. f.) Druce
Pleodendron macranthum	(Baill.) Tiegh.
Pleodendron macranthum	(Baill.) v. Tiegh.
Pleopeltis astrolepis	(Liebm.) E. Fourn.
Pleopeltis astrolepis	(Liebm.) Fourn.
Pleopeltis polypodioides	(L.) Andrews & Windham
Pleopeltis polypodioides	(L.) E.G. Andrews & Windham
Pleopeltis squamata	(L.) J. Sm.
Pleurothallis appendiculata	Cogn.
Pleurothallis aristata	Hook.
Pleurothallis domingensis	Cogn.
Pleurothallis gelida	Lindl.
Pleurothallis obovata	(Lindl.) Lindl.
Pleurothallis pruinosa	Lindl.
Pleurothallis pubescens	Lindl. ex Hook.
Pleurothallis racemiflora	Lindl. ex Hook.
Pleurothallis ruscifolia	(Jacq.) R. Br.
Pleurothallis ruscifolia	(Jacq.) R.Br.
Pleurothallis tricostata	Cogn.
Pleurothallis wilsonii	Lindl.
Pluchea carolinensis	(Jacq.) D.Don
Pluchea carolinensis	(Jacq.) G. Don
Pluchea odorata	(L.) Cass.
Plumbago auriculata	Lam.
Plumbago indica	L.
Plumbago scandens	L.
Plumeria alba	L.
Plumeria obtusa	L.
Plumeria rubra	L.
Poa annua	L.
Poa pratensis	L.
Podocarpus coriaceus	Rich.
Podocarpus macrophyllus	(Thunb.) Sweet
Podranea ricasoliana	(Tanfani) Sprague
Poitea florida	(Vahl)Lavin
Poitea florida	(Vahl) Lavin
Poitea paucifolia	(DC.) Lavin
Poitea punicea	(Urb.) Lavin
Polygala cowellii	(Britton) S.F. Blake
Polygala crucianelloides	DC.
Polygala hecatantha	Urb.
Polygala longicaulis	Kunth
Polygala paniculata	L.
Polygala penaea	L.
Polygala planellasii	Molinet & Maz
Polygonum acuminatum	Kunth
Polygonum glabrum	Willd.
Polygonum hydropiperoides	Michx.
Polygonum punctatum	Elliott
Polygonum robustius	(Small) Fernald
Polygonum segetum	Kunth
Polypodium attenuatum	Humb. & Bonpl. ex Willd.
Polypodium dissimile	L.
Polypodium dulce	Poir.
Polypodium lanceolatum	L.
Polypodium loriceum	L.
Polypodium triseriale	Sw.
Polypogon viridis	(Gouan) Breistr.
Polypremum procumbens	L.
Polyscias cumingiana	(C. Presl) Fernald-Vill.
Polyscias fruticosa	(L.) Harms
Polyscias guilfoylei	(W. Bull) L.H. Bailey
Polyscias guilfoylei	(W.Bull) L.H.Bailey
Polyscias scutellaria	(Burm. f.) Fosberg
Polystachya concreta	(Jacq.) Garay & H.R.Sweet
Polystachya concreta	(Jacq.) Garay & H.R. Sweet
Polystachya foliosa	(Hook.) Rchb.f.
Polystachya foliosa	(Lindl. ex Hook.) Rchb. f.
Polystichopsis chaerophylloides	(Poir.) C.V. Morton
Polystichum calderonense	Proctor
Polystichum echinatum	(J.F. Gmel.) C. Chr.
Polystichum platyphyllum	(Willd.) C. Presl
Polystichum polystichiforme	(Fée) Maxon
Polystichum rhizophyllum	(Sw.) C. Presl
Polytaenium feei	(W. Schaffn. ex Fée) Maxon
Polytrias indica	(Houtt.) Veldkamp
Ponthieva racemosa	(Walter) C. Mohr
Ponthieva ventricosa	(Griseb.) Fawc. & Rendle
Poranopsis paniculata	(Roxb.) Roberty
Porophyllum leiocarpum	(Urb.) Rydb.
Porophyllum ruderale	(Jacq.) Cass.
Portulaca caulerpoides	Britton & P. Wilson ex Britton
Portulaca grandiflora	Hook.
Portulaca halimoides	L.
Portulaca oleracea	L.
Portulaca pilosa	L.
Portulaca quadrifida	L.
Portulaca rubricaulis	Kunth
Portulaca teretifolia	Kunth
Posidonia oceanica	(L.) Delile
Potamogeton foliosus	Raf.
Potamogeton illinoensis	Morong
Potamogeton insulanus	Hagstr.
Potamogeton nodosus	Poir.
Pouteria campechiana	(Kunth) Baehni
Pouteria dictyoneura	(Griseb.) Radlk.
Pouteria hotteana	(Urb. & Ekman) Baehni
Pouteria multiflora	(A. DC.) Eyma
Pouteria sapota	(Jacq.) H.E. Moore & Stearn
Pouzolzia occidentalis	(Liebm.) Weddell
Prescotia oligantha	(Sw.) Lindl.
Prescotia pellucida	Lindl.
Prescotia stachyodes	(Sw.) Lindl.
Prescottia oligantha	(Sw.) Lindl.
Prescottia stachyodes	(Sw.) Lindl.
Prestoea acuminata	(Willd.) H.E.Moore
Prestoea acuminata	(Willd.) H.E. Moore
Prestonia agglutinata	(Jacq.) Woodson
Pristimera caribaea	(Urb.) A.C. Sm.
Priva lappulacea	(L.) Pers.
Priva portoricensis	Urb.
Prockia crucis	P. Br. ex L.
Prosopis pallida	(Humb. & Bonpl. ex Willd.) Kunth
Prosthechea cochleata	(L.) W.E.Higgins
Prosthechea cochleata	(L.) W.E. Higgins
Prosthechea pygmaea	(Hook.) W.E.Higgins
Prosthechea pygmaea	(Hook.) W.E. Higgins
Proustia vanillosma	C. Wright
Prunus myrtifolia	(L.) Urb.
Prunus occidentalis	Sw.
Pseudabutilon umbellatum	(L.) Fryxell
Pseudanamomis umbellulifera	(Kunth) Kausel
Pseudelephantopus spicatus	(B.Juss. ex Aubl.) C.F.Baker
Pseudelephantopus spicatus	(Juss. ex Aubl.) C.F. Baker
Pseudelephantopus spirilis	(Less.) Cronquist
Pseuderanthemum carruthersii	(Seem.) Guillaumin
Pseuderanthemum variabile	(R. Br.) Radlk.
Pseudognaphalium domingense	(Lam.) Anderb.
Pseudogynoxys chenopodioides	Kunth
Pseudolmedia spuria	(Sw.) Griseb.
Pseudophoenix sargentii	H. Wendl. ex Sarg.
Psidium amplexicaule	Pers.
Psidium calyptranthoides	Alain
Psidium cattleianum	Sabine
Psidium guajava	L.
Psidium longipes	(Berg) McVaugh
Psidium sintenisii	(Kiaersk.) Alain
Psiguria ottoniana	(Schltdl.) C. Jeffrey
Psiguria pedata	(L.) Howard
Psiguria trilobata	(L.) Howard
Psilochilus macrophyllus	(Lindl.) Ames
Psilotum nudum	(L.) P. Beauv.
Psychilis kraenzlinii	(Bello) Sauleda
Psychilis krugii	(Bello) Sauleda
Psychilis macconnelliae	Sauleda
Psychilis monensis	Sauleda
Psychilis ×raganii	Sauleda
Psychotria berteriana	DC.
Psychotria berteroana	DC.
Psychotria brachiata	Sw.
Psychotria brownei	Spreng.
Psychotria deflexa	DC.
Psychotria domingensis	Jacq.
Psychotria grandis	Sw.
Psychotria guadalupensis	(DC.) Howard
Psychotria hoffmannseggiana	(Roem. & Schult.) Müll. Arg.
Psychotria ligustrifolia	(Northrop) Millsp.
Psychotria maleolens	Urb.
Psychotria maricaensis	Urb.
Psychotria microdon	(DC.) Urb.
Psychotria nervosa	Sw.
Psychotria nutans	Sw.
Psychotria pubescens	Sw.
Psychotria revoluta	DC.
Psychotria tenuifolia	Sw.
Psychotria uliginosa	Sw.
Pteridium arachnoideum	(Kaulf.) Maxon
Pteridium caudatum	(L.) Maxon
Pteris altissima	Poir.
Pteris arborea	L.
Pteris biaurita	L.
Pteris deflexa	Link
Pteris denticulata	Sw.
Pteris ensiformis	Burm. f.
Pteris grandifolia	L.
Pteris longifolia	L.
Pteris mutilata	L.
Pteris plumula	Desv.
Pteris pungens	Willd.
Pteris tripartita	Sw.
Pteris vittata	L.
Pterocarpus indicus	Willd.
Pterocarpus macrocarpus	Kurz
Pterocarpus officinalis	Jacq.
Pterocaulon alopecuroidies	(Lam.) DC.
Pterocaulon virgatum	(L.) DC.
Pterolepis glomerata	(Rottb.) Miq.
Ptilimnium capillaceum	(Michx.) Raf.
Pueraria phaseoloides	(Roxb.) Benth.
Pueraria phaseoloides	(Roxb.)Benth.
Punica granatum	L.
Pyrostegia venusta	(Ker Gawl.) Miers
Quararibea turbinata	(Sw.) Poir.
Quassia amara	L.
Quisqualis indica	L.
Radiovittaria remota	(Fée) E.H. Crane
Rajania cordata	L.
Randia aculeata	L.
Randia formosa	(Jacq.) K. Schum.
Randia parvifolia	Lam.
Randia portoricensis	(Urb.) Britton & Standl.
Ranunculus recurvatus	Poir.
Raphanus sativus	L.
Rauvolfia nitida	Jacq.
Rauvolfia viridis	Roem. & Schult.
Rauvolfia vomitoria	Afzelius
Ravenala madagascariensis	Sonnerat
Ravenia urbanii	Engl. ex Urb.
Ravenia urbanii	Engl. Ex Urban
Remirea maritima	Aubl.
Renealmia alpinia	(Rottb.) Maas
Renealmia aromatica	(Aubl.) Griseb.
Renealmia jamaicensis	(Gaertn.) Horan.
Renealmia occidentalis	(Sw.) Sweet
Reynosia guama	Urb.
Reynosia krugii	Urb.
Reynosia uncinata	Urb.
Rhabdadenia biflora	(Jacq.) Müll. Arg.
Rhexia cubensis	Griseb.
Rhipsalis baccifera	(J.S.Muell.) Stearn
Rhipsalis baccifera	(Sol. ex J.S. Muell.) Stearn
Rhizophora mangle	L.
Rhynchosia caribaea	(Jacq.) DC.
Rhynchosia minima	(L.) DC.
Rhynchosia phaseoloides	(Sw.) DC.
Rhynchosia reticulata	(Sw.) DC.
Rhynchospora alba	(L.) Vahl
Rhynchospora berteroi	(Spreng.) C.B. Clarke
Rhynchospora brachychaeta	C. Wright
Rhynchospora ciliata	(G. Mey.) Kük.
Rhynchospora ciliata	(G.Mey.) Kük.
Rhynchospora colorata	(L.) H. Pfeiffer
Rhynchospora contracta	(Nees) J. Raynal
Rhynchospora corymbosa	(L.) Britton
Rhynchospora depressirostris	M.T. Strong
Rhynchospora divaricata	(Ham.) M.T. Strong
Rhynchospora divergens	Chapm. ex M.A. Curtis
Rhynchospora domingensis	Urb.
Rhynchospora fascicularis	(Michx.) Vahl
Rhynchospora filiformis	Vahl
Rhynchospora galeana	Naczi, W.M. Knapp & Gerry Moore
Rhynchospora gigantea	Link
Rhynchospora globularis	(Chapm.) Small
Rhynchospora holoschoenoides	(Rich.) Herter
Rhynchospora jamaicensis	Britton
Rhynchospora lindeniana	Griseb.
Rhynchospora marisculus	Nees ex Lindl. & Nees
Rhynchospora microcarpa	Baldw. ex A. Gray
Rhynchospora nitens	(Vahl) A. Gray
Rhynchospora odorata	C. Wright ex Griseb.
Rhynchospora oligantha	A. Gray
Rhynchospora plumosa	Elliott
Rhynchospora pusilla	Chapm. ex M.A. Curtis
Rhynchospora racemosa	C. Wright ex Sauvalle
Rhynchospora radicans	(Schltdl. & Cham.) H. Pfeifer
Rhynchospora radicans	(Schltdl. & Cham.) H.Pfeiff.
Rhynchospora rariflora	(Michx.) Elliott
Rhynchospora recognita	(Gale) Kral
Rhynchospora rufa	(Nees) Boeckeler
Rhynchospora rugosa	(Vahl) Gale
Rhynchospora tenerrima	Nees ex Spreng.
Rhynchospora tenuis	Link
Rhynchospora uniflora	Boeckeler
Rhynchospora wrightiana	Boeckeler
Rhytidophyllum auriculatum	Hook.
Richardia scabra	L.
Ricinus communis	L.
Rivina humilis	L.
Rochefortia acanthophora	(DC.) Griseb.
Rochefortia spinosa	(Jacq.) Urb.
Rolandra fruticosa	(L.) Kuntze
Rollinia mucosa	(Jacq.) Baill.
Rondeletia inermis	(Spreng.) Krug & Urb.
Rondeletia pilosa	Sw.
Rondeletia portoricensis	Krug & Urb.
Rorippa indica	(L.) Hiern.
Rorippa palustris	(L.) Besser
Rorippa portoricensis	(Spreng.) Stehlé
Rosa indica	L.
Rosa moschata	J. Herrm.
Rosa sempervirens	L.
Rosmarinus officinalis	L.
Rotala ramosior	(L.) Koehne
Rottboellia cochinchinensis	(Lour.) W.D. Clayton
Rourea surinamensis	Miq.
Rousselia humilis	(Sw.) Urb.
Roystonea borinquena	O.F.Cook
Roystonea borinquena	O.F. Cook
Roystonea regia	(Kunth) O.F. Cook, nom. cons.
Rubus coronarius	(Sims) Sweet
Rubus florulentus	Focke
Rubus probus	L.H. Bailey
Rubus rosifolius	Sm.
Ruellia blechum	L.
Ruellia caerulea	Morong
Ruellia chartacea	(T. Anderson) Wassh.
Ruellia coccinea	(L.) Vahl
Ruellia coccinea	Sessé & Moc.
Ruellia tuberosa	L.
Rumex crispus	L.
Rumohra adiantiformis	(G. Forst.) Ching
Ruppia anomala	Ostenf.
Ruppia cirrhosa	(Petagna) Grande
Ruppia maritima	L.
Russelia equisetiformis	Schltdl. & Cham.
Ruta chalepensis	L.
Sabal causiarum	(O.F. Cook) Becc.
Sabicea cinerea	Aubl.
Sabicea villosa	Willd. ex Roem. & Schult.
Saccharum bengalense	Retz.
Saccharum officinarum	L.
Saccharum spontaneum	L.
Sacciolepis indica	(L.) Chase
Sacciolepis striata	(L.) Nash
Saccoloma domingense	(Spreng.) C. Chr.
Saccoloma inaequale	(Kunze) Mett.
Sagittaria intermedia	Micheli
Sagittaria lancifolia	L.
Sagittaria latifolia	Willd.
Sagraea domingensis	DC.
Sagraea polystachya	(Naud.) Triana
Sagraea portoricensis	(Alain) Alain
Sagraea scabrosa	(L.) Alain
Sagraea scalpta	(Vent.) Naud.
Sagraea umbrosa	(Sw.) DC.
Salicornia bigelovii	Torr.
Salix humboldtiana	Willd.
Salix ×sepulcralis	Simonkai
Salmea scandens	(L.) DC.
Salvia coccinea	P.J. Buchoz ex Etlinger
Salvia micrantha	Vahl
Salvia misella	Kunth
Salvia occidentalis	Sw.
Salvia serotina	L.
Salvia splendens	Sellow ex Roem. & Schult.
Salvinia auriculata	Aubl.
Salvinia minima	Baker
Samanea saman	(Jacq.) Merr.
Sambucus nigra	L.
Samolus valerandi	L.
Samyda dodecandra	Jacq.
Samyda spinulosa	Vent.
Sanchezia speciosa	Leonard
Sansevieria hyacinthoides	(L.) Druce
Sansevieria trifasciata	hort. ex Prain
Sapindus saponaria	L.
Sapium laurifolium	(A. Rich.) Griseb.
Sapium laurocerasus	Desf.
Saritaea magnifica	(Sprague ex Stennis) Dugand
Satureja viminea	L.
Sauvagesia erecta	L.
Savia sessiliflora	(Sw.) Willd.
Scaevola plumieri	(L.) Vahl
Scaphyglottis modesta	(Rchb. f.) Schltr.
Scaphyglottis modesta	(Rchb.f.) Schltr.
Schaefferia frutescens	Jacq.
Schefflera actinophylla	(Endl.) Harms
Schefflera gleasonii	(Britton & P. Wilson) Alain
Schefflera morototoni	(Aubl.) Maguire, Steyerm. & Frodin
Schefflera morototonii	(Aubl.) Maguire, Steyerm. & Frodin
Schinus molle	L.
Schinus terebinthifolius	Raddi
Schizachyrium brevifolium	(Sw.) Nees ex Büse
Schizachyrium sanguineum	(Retz.) Alston
Schizachyrium tenerum	Nees
Schizaea fluminensis	Miers ex Sturm
Schizaea poeppigiana	Sturm
Schizolobium parahybum	(Vell.) S.F. Blake
Schlegelia brachyantha	Griseb.
Schoenoplectus americanus	(Pers.) Volkart ex Schinz & R. Keller
Schoenoplectus tabernaemontani	(C.C. Gmel.) Palla
Schoepfia arenaria	Britton
Schoepfia obovata	C. Wright
Schoepfia schreberi	J.F. Gmel.
Schradera exotica	(J.F. Gmel.) Standl.
Schradera exotica	(J.F.Gmel.) Standl.
Schultesia brachyptera	Cham.
Schultesia heterophylla	Miq., nom. inq.
Scleria canescens	Boeckeler
Scleria ciliata	Michx.
Scleria cubensis	Boeckeler
Scleria eggersiana	Boeckeler
Scleria gaertneri	Raddi
Scleria georgiana	Core
Scleria havanensis	Britton
Scleria hirtella	Sw.
Scleria lithosperma	(L.) Sw.
Scleria microcarpa	Nees ex Kunth
Scleria mucronata	Poir.
Scleria muehlenbergii	Steud.
Scleria oligantha	Michx.
Scleria pauciflora	Muhl. ex Willd.
Scleria pterota	C. Presl ex C.B. Clarke
Scleria reticularis	Michx.
Scleria scindens	Nees ex Kunth
Scleria secans	(L.) Urb.
Scleria triglomerata	Michx.
Scleria verticillata	Muhl. ex Willd.
Sclerocarpus africanus	Jacq.
Scolosanthus grandifolius	Krug & Urb.
Scolosanthus portoricensis	Borhidi
Scolosanthus versicolor	Vahl
Scoparia dulcis	L.
Scrophularia minutiflora	Pennell
Scutellaria havanensis	Jacq.
Scybalium jamaicense	(Sw.) Schott & Endl.
Sechium edule	(Jacq.) Sw.
Securidaca diversifolia	(L.) S.F. Blake
Securidaca virgata	Sw.
Selaginella armata	Baker
Selaginella cordifolia	(Desv. ex Poir.) Spring
Selaginella krugii	Hieron.
Selaginella laxifolia	Baker
Selaginella ovifolia	Baker
Selaginella plana	(Desv. ex Poir.) Hieron.
Selaginella plumosa	(L.) C. Presl
Selaginella subcaulescens	Baker
Selaginella substipitata	Spring
Selaginella tenella	(P. Beauv.) Spring
Selaginella willdenowii	(Desv. ex Poir.) Baker
Selenicereus grandiflorus	(L.) Britton & Rose
Senna alata	(L.) Roxb.
Senna atomaria	(L.) Irwin & Barneby
Senna bacillaris	(L. f.) Irwin & Barneby
Senna bicapsularis	(L.) Roxb.
Senna ×floribunda	(Cav.) Irwin & Barneby
Senna hirsuta	(L.) Irwin & Barneby
Senna ligustrina	(L.) Irwin & Barneby
Senna multijuga	(Rich.) Irwin & Barneby
Senna nitida	(Rich.) Irwin & Barneby
Senna obtusifolia	(L.) Irwin & Barneby
Senna occidentalis	(L.) Link
Senna pendula	(Humb. & Bonpl. ex Willd.) Irwin & Barneby
Senna polyphylla	(Jacq.) Irwin & Barneby
Senna septemtrionalis	(Viv.) H. Irwin & Barneby
Senna siamea	(Lam.)H.S.Irwin & Barneby
Senna siamea	(Lam.) Irwin & Barneby
Senna sophera	(L.) Roxb.
Senna spectabilis	(DC.) Irwin & Barneby
Senna surattensis	(Burm. f.) Irwin & Barneby
Senna uniflora	(Mill.) Irwin & Barneby
Serjania diversifolia	(Jacq.) Radlk.
Serjania polyphylla	(L.) Radlk.
Serpocaulon dissimile	(L.) A.R. Sm.
Serpocaulon loriceum	(L.) A.R. Sm.
Sesamum orientale	L.
Sesbania bispinosa	(Jacq.) W. Wight
Sesbania grandiflora	(L.) Poir.
Sesbania herbacea	(Mill.) McVaugh
Sesbania sericea	(Willd.) Link
Sesbania sesban	(L.) Merr.
Sesbania tomentosa	Hook. & Arn.
Sesuvium maritimum	(Walter) Britton, Sterns & Poggenb.
Sesuvium microphyllum	Willd.
Sesuvium portulacastrum	(L.) L.
Setaria barbata	(Lam.) Kunth
Setaria magna	Griseb.
Setaria parviflora	(Poir.) Kerguélen
Setaria parviflora	(Poir.) M.Kerguelen
Setaria pradana	(Léon ex Hitchc.) Léon
Setaria rariflora	Mikan ex Trin.
Setaria setosa	(Sw.) P. Beauv.
Setaria tenacissima	Schrad.
Setaria utowanaea	(Scribn. ex Millsp.) Pilg.
Setaria vulpiseta	(Lam.) Roem. & Schult.
Sicana odorifera	(Vell.) Naud.
Sida abutifolia	Mill.
Sida acuta	Burm. f.
Sida acuta	Burm.f.
Sida ciliaris	L.
Sida cordata	(Burm. f.) Waalkes
Sida cordifolia	L.
Sida glabra	Mill.
Sida glomerata	Comm. ex Cav.
Sida glutinosa	Comm. ex Cav.
Sida jamaicensis	L.
Sida repens	Domb. ex Cav.
Sida rhombifolia	L.
Sida salviifolia	C. Presl
Sida spinosa	L.
Sida stipularis	Cav.
Sidastrum multiflorum	(Jacq.) Fryxell
Sida urens	L.
Sideroxylon cubense	(Griseb.) T.D. Penn.
Sideroxylon foetidissimum	Jacq.
Sideroxylon obovatum	Lam.
Sideroxylon portoricense	Urb.
Sideroxylon salicifolium	(L.) Lam.
Simarouba amara	Aubl.
Simarouba tulae	Urb.
Sinapis alba	L.
Siphoneugena densiflora	Berg
Siphonoglossa sessilis	(Jacq.) D. Gibson
Sisyrinchium rosulatum	E.P. Bicknell
Sloanea amygdalina	Griseb.
Sloanea berteriana	Choisy ex DC.
Sloanea berteroana	Choisy ex DC.
Smilax coriacea	Spreng.
Smilax domingensis	Willd.
Smilax smallii	Morong
Solandra grandiflora	Sw.
Solanum americanum	Mill.
Solanum bahamense	L.
Solanum campechiense	L.
Solanum capsicoides	All.
Solanum elaeagnifolium	Cav.
Solanum erianthum	D. Don
Solanum jamaicense	Mill.
Solanum lanceifolium	Jacq.
Solanum lycopersicum	L.
Solanum mammosum	L.
Solanum melongena	L.
Solanum mucronatum	O.E. Schulz
Solanum nigrescens	M. Martens & Galeotti
Solanum nudum	Kunth ex Dunal
Solanum polygamum	Vahl
Solanum pyrifolium	Lam.
Solanum quitoense	Lam.
Solanum racemosum	Jacq.
Solanum riedlei	Dunal
Solanum rugosum	Dunal
Solanum seaforthianum	Andrews
Solanum torvum	Sw.
Solanum tuberosum	L.
Solanum wendlandii	Hook. f.
Solanum woodburyi	Howard
Solenostemon scutellarioides	(L.) Codd
Solidago sempervirens	L.
Sonchus asper	(L.) Hill
Sonchus oleraceus	L.
Sophora tomentosa	L.
Sorghastrum setosum	(Griseb.) Hitchc.
Sorghastrum stipoides	(Kunth) Nash
Sorghum bicolor	(L.) Moench
Sorghum halepense	(L.) Pers.
Spartina patens	(Aiton) Muhl.
Spathiphyllum wallisii	Regel
Spathodea campanulata	P. Beauv.
Spathodea campanulata	P.Beauv.
Spathoglottis plicata	Blume
Spermacoce assurgens	Ruiz & Pav.
Spermacoce confusa	Rendle
Spermacoce densiflora	(DC.) Alain
Spermacoce eryngioides	(Cham. & Schltdl.) Kuntze
Spermacoce ocymifolia	Willd. ex Roem. & Schult.
Spermacoce prostrata	Aubl.
Spermacoce remota	Lam.
Spermacoce sintenisii	(Urb.) Alain
Spermacoce tenuior	L.
Spermacoce verticillata	L.
Sphagneticola gracilis	(Rich.) Pruski
Sphagneticola trilobata	(L.) Pruski
Sphagnum portoricense	Hampe
Sphenoclea zeylanica	Gaertn.
Spigelia anthelmia	L.
Spiracantha cornifolia	Kunth
Spiranthes torta	(Thunb.) Garay & H.R.Sweet
Spiranthes torta	(Thunb.) Garay & H.R. Sweet
Spirodela polyrrhiza	(L.) Schleid.
Spondias dulcis	Parkinson
Spondias mombin	L.
Spondias purpurea	L.
Sporobolus cubensis	Hitchc.
Sporobolus domingensis	(Trin.) Kunth
Sporobolus indicus	(L.) R. Br.
Sporobolus indicus	(L.) R.Br.
Sporobolus jacquemontii	Kunth
Sporobolus pyramidatus	(Lam.) Hitchc.
Sporobolus tenuissimus	(Mart. ex Schrank) Kuntze
Sporobolus virginicus	(L.) Kunth
Stachys arvensis	(L.) L.
Stachytarpheta cayennensis	(Rich.) Vahl
Stachytarpheta ×hybrida	Moldenke
Stachytarpheta jamaicensis	(L.) Vahl
Stachytarpheta strigosa	Vahl
Stachytarpheta urticifolia	Sims
Stahlia monosperma	(Tul.) Urb.
Stegnosperma cubense	A. Rich.
Steinchisma laxum	(Sw.) Zuloaga
Stelis perpusilliflora	Cogn.
Stelis pygmaea	Cogn.
Stellaria antillana	Urb.
Stemodia durantifolia	(L.) Sw.
Stemodia maritima	L.
Stemodia verticillata	(Mill.) Hassler
Stenandrium tuberosum	(L.) Urb.
Stenocereus fimbriatus	(Lam.) Lourteig
Stenorrhynchos lanceolatum	(Aubl.) Rich.
Stenorrhynchos speciosum	(Jacq.) Rich. ex Spreng.
Stenostomum obtusifolium	(Urb.) Britton & P.Wilson
Stenotaphrum secundatum	(Walter) Kuntze
Sterculia apetala	(Jacq.) Karst.
Sterculia foetida	L.
Sticherus bifidus	(Willd.) Ching
Sticherus brevipubis	(Christ) A.R. Sm.
Stictocardia tiliifolia	(Desr.) Hallier f.
Stigmaphyllon bannisterioides	(L.) C.E. Anderson
Stigmaphyllon diversifolium	(Kunth) A. Juss.
Stigmaphyllon emarginatum	(Cav.) A. Juss.
Stigmaphyllon floribundum	(DC.) C.E. Anderson
Stigmaphyllon puberum	(Rich.) A. Juss.
Struchium sparganophorum	(L.) Kuntze
Strumpfia maritima	Jacq.
Stylogyne lateriflora	(Sw.) Mez
Stylosanthes erecta	P. Beauv.
Stylosanthes hamata	(L.) Taubert
Stylosanthes viscosa	(L.) Sw.
Styrax portoricensis	Krug & Urb.
Suriana maritima	L.
Swietenia macrophylla	King
Swietenia mahagoni	(L.) Jacq.
Symphyotrichum expansum	(Poepp. ex Spreng.) G.L. Nesom
Symphysia racemosa	(Vahl) Stearn
Symplocos lanata	Krug & Urb.
Symplocos latifolia	Krug & Urb.
Symplocos martinicensis	Jacq.
Symplocos micrantha	Krug & Urb.
Synedrella nodiflora	(L.) Gaertn.
Syngonium auritum	(L.) Schott
Syngonium podophyllum	Schott
Syzygium grande	(Wight) Wight ex Walp.
Syzygium jambos	(L.) Alston
Syzygium malaccense	(L.) Merr. & L.M. Perry
Tabebuia aurea	(Manso) Benth. & Hook. f. ex S. Moore
Tabebuia chrysantha	(Jacq.) G. Nicholson
Tabebuia donnell-smithii	Rose
Tabebuia haemantha	(Bertol. ex Spreng.) DC.
Tabebuia heterophylla	(DC.) Britton
Tabebuia rigida	Urb.
Tabebuia rosea	(Bertol.) DC.
Tabebuia schumanniana	Urb.
Tabebuia serratifolia	(Vahl) G. Nicholson
Tabernaemontana citrifolia	L.
Tabernaemontana divaricata	(L.) R. Br. ex Roem. & Schult.
Tagetes erecta	L.
Tagetes patula	L.
Talinum paniculatum	(Jacq.) Gaertn.
Talinum triangulare	(Jacq.) Willd.
Talipariti tiliaceum	(L.) Fryxell
Tamarindus indica	L.
Tamarix aphylla	(L.) Karst.
Tamarix gallica	L.
Tamonea boxiana	(Moldenke) Howard
Taraxacum officinale	F.H. Wigg.
Tecoma capensis	(Thunb.) Lindl.
Tecoma stans	(L.) Juss. ex Kunth
Tectaria cicutaria	(L.) Copeland
Tectaria estremeriana	Proctor & A.M. Evans
Tectaria fimbriata	(Willd.) Proctor & Lourteig
Tectaria heracleifolia	(Willd.) Underw.
Tectaria incisa	Cav.
Tectaria plantaginea	(Jacq.) Maxon
Tectaria prolifera	(Hook.) R.M. Tryon & A.F. Tryon
Tectaria trifoliata	(L.) Cav.
Tectona grandis	L. f.
Tectona grandis	L.f.
Teliostachya alopecuroidea	(Vahl) Nees
Tephrosia candida	DC.
Tephrosia cinerea	(L.) Pers.
Tephrosia noctiflora	Bojer ex Baker
Tephrosia senna	Kunth
Tephrosia sessiliflora	(Poir.) Hassler
Teramnus labialis	(L. f.) Spreng.
Teramnus uncinatus	(L.) Sw.
Terminalia catappa	L.
Terminalia ivorensis	A. Chev.
Terminalia myriocarpa	van Heurck & Müll. Arg.
Terminalia oblonga	(Ruiz & Pav.) Eichler
Ternstroemia heptasepala	Krug & Urb.
Ternstroemia luquillensis	Krug & Urb.
Ternstroemia peduncularis	DC.
Ternstroemia stahlii	Krug & Urb.
Ternstroemia subsessilis	(Britton) Kobuski
Terpsichore mollissima	(Fée) A.R. Sm.
Tetragastris balsamifera	(Sw.) Oken
Tetragonia tetragonioides	(Pall.) Kuntze
Tetramicra canaliculata	(Aubl.) Urb.
Tetrapterys inaequalis	Cav.
Tetrazygia angustifolia	(Sw.) DC.
Tetrazygia biflora	(Cogn.) Urb.
Tetrazygia crotonifolia	(Desr.) DC.
Tetrazygia elaeagnoides	(Sw.) DC.
Tetrazygia urbanii	Cogn.
Thalassia testudinum	Banks & Sol. ex Koenig
Thalia geniculata	L.
Thelypteris abdita	Proctor
Thelypteris abrupta	(Desv.) Proctor
Thelypteris angustifolia	(Willd.) Proctor
Thelypteris balbisii	(Spreng.) Ching
Thelypteris brittonae	(Slosson ex Maxon) Alain
Thelypteris cheilanthoides	(Kunze) Proctor
Thelypteris cordata	(Fée) Proctor
Thelypteris decussata	(L.) Proctor
Thelypteris deltoidea	(Sw.) Proctor
Thelypteris dentata	(Forssk.) E.P. St. John
Thelypteris germaniana	(Fée) Proctor
Thelypteris grandis	A.R. Sm.
Thelypteris guadalupensis	(Wikstr.) Proctor
Thelypteris hastata	(Fée) Proctor
Thelypteris hildae	Proctor
Thelypteris hispidula	(Decne.) C.F. Reed
Thelypteris inabonensis	Proctor
Thelypteris interrupta	(Willd.) K. Iwats.
Thelypteris ×invisa	(Sw.) Proctor (pro sp.)
Thelypteris kunthii	(Desv.) C.V. Morton
Thelypteris kunthii	(Desv.) Morton
Thelypteris leptocladia	(Fée) Proctor
Thelypteris linkiana	(C. Presl) R. Tryon
Thelypteris namatophila	Proctor
Thelypteris nephrodioides	(Klotzsch) Proctor
Thelypteris opposita	(Vahl) Ching
Thelypteris patens	(Sw.) Small ex R.P. St. John
Thelypteris pennata	(Poir.) Morton
Thelypteris piedrensis	(C. Chr.) Morton
Thelypteris poiteana	(Bory) Proctor
Thelypteris reptans	(J.F. Gmel.) Morton
Thelypteris resinifera	(Desv.) Proctor
Thelypteris reticulata	(L.) Proctor
Thelypteris retroflexa	(L.) Proctor & Lourteig
Thelypteris rheophyta	Proctor
Thelypteris ×rolandii	(C. Chr.) R. Tryon
Thelypteris rudis	(Kunze) Proctor
Thelypteris sancta	(L.) Ching
Thelypteris sclerophylla	(Poepp. ex Spreng.) Morton
Thelypteris serra	(Sw.) R.P. St. John
Thelypteris serrata	(Cav.) Alston
Thelypteris tetragona	(Sw.) Small
Thelypteris verecunda	Proctor
Thelypteris yaucoensis	Proctor
Themeda arguens	(L.) Hack.
Theobroma cacao	L.
Thespesia grandiflora	DC.
Thespesia populnea	(L.) Sol. ex Corrêa
Thevetia peruviana	(Pers.) K. Schum.
Thouinia striata	Radlk.
Thunbergia alata	Bojer ex Sims
Thunbergia erecta	(Benth.) T. Anderson
Thunbergia fragrans	Roxb.
Thunbergia grandiflora	Roxb.
Tibouchina granulosa	(Desr.) Cogn.
Tibouchina urvilleana	(DC.) Cogn.
Tillandsia ariza-juliae	L.B. Sm. & Jiménez
Tillandsia bartramii	Elliott
Tillandsia borinquensis	Cedeño-Mald. & Proctor
Tillandsia bulbosa	Hook.
Tillandsia fasciculata	Sw.
Tillandsia flexuosa	Sw.
Tillandsia lineatispica	Mez
Tillandsia polystachia	(L.) L.
Tillandsia pruinosa	Sw.
Tillandsia recurvata	(L.) L.
Tillandsia setacea	Sw.
Tillandsia tenuifolia	L.
Tillandsia usneoides	(L.) L.
Tillandsia utriculata	L.
Tillandsia variabilis	Schltdl.
Tithonia diversifolia	(Hemsl.) A. Gray
Tithonia rotundifolia	(Mill.) S.F. Blake
Tolumnia prionochila	(Kraenzlin) G.J. Braem
Tolumnia variegata	(Sw.) G.J. Braem
Toona ciliata	Roem.
Torralbasia cuneifolia	(C. Wright) Krug & Urb.
Tournefortia bicolor	Sw.
Tournefortia filiflora	Griseb.
Tournefortia hirsutissima	L.
Tournefortia laurifolia	Vent.
Tournefortia maculata	Jacq.
Tournefortia scabra	Lam.
Tournefortia volubilis	L.
Tradescantia pallida	(Rose) D.R. Hunt
Tradescantia spathacea	Sw.
Tradescantia zanonia	(L.) Sw.
Tradescantia zebrina	hort. ex Bosse
Tragia volubilis	L.
Tragus berteronianus	Schult.
Trema lamarckiana	(Schult.) Blume
Trema micrantha	(L.) Blume
Trema micranthum	(L.) Blume, orth. var.
Trianthema portulacastrum	L.
Tribulus cistoides	L.
Trichilia hirta	L.
Trichilia pallida	Sw.
Trichilia triacantha	Urb.
Trichomanes alatum	Sw.
Trichomanes angustifrons	(Fée) W. Boer
Trichomanes capillaceum	L.
Trichomanes crispum	L.
Trichomanes holopterum	Kunze
Trichomanes hookeri	C. Presl
Trichomanes hymenoides	Hedw.
Trichomanes hymenophylloides	Bosch
Trichomanes kapplerianum	Sturm
Trichomanes krausii	Hook. & Grev.
Trichomanes lineolatum	(Bosch) Hook.
Trichomanes membranaceum	L.
Trichomanes ovale	(Fourn.) W. Boer
Trichomanes padronii	Proctor
Trichomanes pinnatum	Hedw.
Trichomanes polypodioides	L.
Trichomanes punctatum	Poir.
Trichomanes pusillum	Sw.
Trichomanes radicans	Sw.
Trichomanes rigidum	Sw.
Trichomanes robustum	Fourn.
Trichomanes scandens	L.
Trichosalpinx dura	(Lindl.) Luer
Trichostigma octandrum	(L.) H. Walt.
Trichostigma octandrum	(L.) H.Walter
Tridax procumbens	L.
Trifolium pratense	L.
Trimezia steyermarkii	R.C.Foster
Trimezia steyermarkii	R.C. Foster
Triphasia trifolia	(Burm. f.) P. Wilson
Triphora amazonica	Schltr.
Triphora hassleriana	(Cogn.) Schltr.
Triphora surinamensis	(Lindl.) Britton
Triphora surinamensis	(Lindl. ex Benth.) Britton
Triplaris cumingiana	Fisch. & C.A. Mey. ex C.A. Mey.
Triplophyllum funestum	(Kunze) Holttum
Tripogandra serrulata	(Vahl) Handlos
Tripsacum fasciculatum	Trin. ex Asch.
Tripsacum latifolium	Hitchc.
Triticum aestivum	L.
Triumfetta lappula	L.
Triumfetta rhomboidea	Jacq.
Triumfetta semitriloba	Jacq.
Tropaeolum majus	L.
Trophis racemosa	(L.) Urb.
Tropidia polystachya	(Sw.) Ames
Turbina corymbosa	(L.) Raf.
Turnera diffusa	Willd. ex Schult.
Turnera pumilea	L.
Turnera ulmifolia	L.
Turpinia occidentalis	(Sw.) G.Don
Turpinia occidentalis	(Sw.) G. Don
Tynanthus polyanthus	(Bureau) Sandw.
Typha domingensis	Pers.
Urena lobata	L.
Urena sinuata	L.
Urera baccifera	(L.) Gaudich.
Urera baccifera	(L.) Gaudich. ex Wedd.
Urera caracasana	(Jacq.) Gaudich. ex Griseb.
Urera chlorocarpa	Urb.
Urochloa adspersa	(Trin.) R. Webster
Urochloa arrecta	(Hack. ex T. Dur. & Schinz) O. Morrone & F. Zuloaga
Urochloa brizantha	(Hochst. ex A. Rich.) R. Webster
Urochloa decumbens	(Stapf) R. Webster
Urochloa distachya	(L.) T.Q. Nguyen
Urochloa fusca	(Sw.) B.F. Hansen & Wunderlin
Urochloa maxima	(Jacq.) R. Webster
Urochloa mosambicensis	(Hack.) Dandy
Urochloa mutica	(Forssk.) T.Q. Nguyen
Urochloa plantaginea	(Link) R. Webster
Urochloa reptans	(L.) Stapf
Utricularia gibba	L.
Utricularia juncea	Vahl
Utricularia pusilla	Vahl
Utricularia subulata	L.
Valeriana scandens	L.
Vangueria madagascariensis	J.F. Gmel.
Vanilla barbellata	Rchb. f.
Vanilla claviculata	(W. Wright) Sw.
Vanilla dilloniana	Correll
Vanilla mexicana	Mill.
Vanilla planifolia	Jacks.
Vanilla planifolia	Jacks. ex Andrews
Vanilla poitaei	Rchb. f.
Vanilla poitaei	Rchb.f.
Vanilla pompona	Schiede
Varronia polycephala	Lam.
Verbena bonariensis	L.
Verbena incompta	P.W. Michael
Verbena rigida	Spreng.
Verbena scabra	Vahl
Verbesina alata	L.
Verbesina encelioides	(Cav.) Benth. & Hook. f. ex A. Gray
Vernicia fordii	(Hemsl.) Airy-Shaw
Vernonia albicaulis	Pers.
Vernonia borinquensis	Urb.
Vernonia proctori	Urbatsch
Vernonia sericea	Rich.
Veronica peregrina	L.
Vetiveria zizanioides	(L.) Nash
Vigna adenantha	(G. Mey.) Maréchal, Mascherpa & Stainier
Vigna adenantha	(G. Mey.) Marechal, Mascherpa & Stanier
Vigna antillana	(Urb.) Fawc. & Rendle
Vigna hosei	(Craib) Backer
Vigna juruana	(Harms) Verdc.
Vigna longifolia	(Benth.) Verdc.
Vigna luteola	(Jacq.) Benth.
Vigna marina	(Burm. f.) Merr.
Vigna peduncularis	(Kunth) Fawc. & Rendle
Vigna unguiculata	(L.) Walp.
Vigna vexillata	(L.) A. Rich.
Viola odorata	L.
Vitex agnus-castus	L.
Vitex divaricata	Sw.
Vitex parviflora	A.Juss.
Vitex parviflora	Juss.
Vitis tiliifolia	Humb. & Bonpl. ex Schult.
Vitis vinifera	L.
Vittaria costata	Kunze
Vittaria graminifolia	Kaulf.
Vittaria lineata	(L.) Sm.
Vittaria remota	Fée
Voyria aphylla	(Jacq.) Pers.
Voyria parasitica	(Schltdl. & Cham.) Ruyters & Maas
Voyria tenella	Guilding ex Hook.
Voyria tenella	Hook.
Vriesea macrostachya	(Bello) Mez
Vriesea proctorii	(Cedeño-Mald.) Acev.-Rodr.
Vriesea ringens	(Griseb.) Harms
Vriesea sintenisii	(Baker) L.B. Sm. & Pittendr.
Vulpia bromoides	(L.) Gray
Waldsteinia pendula	(Urb.) Mez
Wallenia lamarckiana	(A. DC.) Mez
Wallenia yunquensis	(Urb.) Mez
Waltheria calcicola	Urb.
Waltheria indica	L.
Websteria confervoides	(Poir.) S. Hooper
Wedelia fruticosa	Jacq.
Wedelia lanceolata	DC.
Wedelia parviflora	Rich.
Wedelia reticulata	DC.
Weinmannia pinnata	L.
Wissadula amplissima	(L.) R.E. Fries
Wissadula periplocifolia	(L.) C. Presl ex Thwaites
Wolffia brasiliensis	Weddell
Wolffiella lingulata	(Hegelm.) Hegelm.
Wolffiella welwitschii	(Hegelm.) Monod
Wullschlaegelia aphylla	(Sw.) Rchb. f.
Wullschlaegelia calcarata	Benth.
Xanthium strumarium	L.
Xanthosoma atrovirens	K. Koch & Bouché
Xanthosoma brasiliense	(Desf.) Engl.
Xanthosoma caracu	K. Koch & Bouché
Xanthosoma helleborifolium	(Jacq.) Schott
Xanthosoma sagittifolium	(L.) Schott
Xanthosoma undipes	(K. Koch) K. Koch
Xanthosoma violaceum	Schott
Xenostegia tridentata	(L.) Austin & Staples
Ximenia americana	L.
Xiphidium caeruleum	Aubl.
Xylosma buxifolia	A. Gray
Xylosma pachyphylla	(Krug & Urb.) Urb.
Xylosma schaefferioides	A. Gray
Xylosma schwaneckeana	(Krug & Urb.) Urb.
Xylosma schwaneckeana	Urb.
Xyris caroliniana	Walter
Xyris difformis	Chapm.
Xyris elliottii	Chapm.
Xyris jupicai	Rich.
Youngia japonica	(L.) DC.
Yucca aloifolia	L.
Yucca gloriosa	L.
Yucca guatemalensis	Baker
Zamia amblyphyllidia	D.W. Stev.
Zamia portoricensis	Urb.
Zamia pumila	L.
Zantedeschia aethiopica	(L.) Spreng.
Zanthoxylum bifoliolatum	Leonard
Zanthoxylum caribaeum	Lam.
Zanthoxylum flavum	Vahl
Zanthoxylum martinicense	(Lam.) DC.
Zanthoxylum monophyllum	(Lam.) P. Wilson
Zanthoxylum punctatum	Vahl
Zanthoxylum spinifex	(Jacq.) DC.
Zanthoxylum thomasianum	(Krug & Urb.) Krug & Urb. ex P. Wilson
Zapoteca portoricensis	(Jacq.) H.M. Hern.
Zea mays	L.
Zephyranthes citrina	Baker
Zephyranthes grandiflora	Lindl.
Zephyranthes proctorii	Acev.-Rodr. & M.T. Strong
Zephyranthes puertoricensis	Traub
Zephyranthes rosea	Lindl.
Zeuxine strateumatica	(L.) Schltr.
Zingiber montanum	(J. Koenig) Link ex A. Dietr.
Zingiber officinale	Roscoe
Zingiber spectabile	Griff.
Zingiber zerumbet	(L.) Sm.
Zinnia peruviana	(L.) L.
Zinnia violacea	Cav.
Ziziphus mauritiana	Lam.
Ziziphus reticulata	(Vahl) DC.
Ziziphus rignonii	Delponte
Ziziphus taylorii	(Britton) M.C. Johnst.
Zornia gemella	Vogel
Zornia reticulata	Sm.
Zoysia matrella	(L.) Merr.
Zoysia tenuifolia	Willd. ex Thiele
Zygophlebia sectifrons	(Kunze ex Mett.) Bishop
